,Player,Pos,Age,Tm,G,GS,MP,FG,FGA,3P,3PA,2P,2PA,FT,FTA,ORB,DRB,TRB,AST,STL,BLK,TOV,PF,PTS
0,Precious Achiuwa,C,22,TOR,73,28,1725,265,603,56,156,209,447,78,131,146,327,473,82,37,41,84,151,664
1,Steven Adams,C,28,MEM,76,75,1999,210,384,0,1,210,383,108,199,349,411,760,256,65,60,115,153,528
2,Bam Adebayo,C,24,MIA,56,56,1825,406,729,0,6,406,723,256,340,137,427,564,190,80,44,148,171,1068
3,Santi Aldama,PF,21,MEM,32,0,360,53,132,6,48,47,84,20,32,33,54,87,21,6,10,16,36,132
4,LaMarcus Aldridge,C,36,BRK,47,12,1050,252,458,14,46,238,412,89,102,73,185,258,42,14,47,44,78,607
5,Nickeil Alexander-Walker,SG,23,TOT,65,21,1466,253,680,105,338,148,342,81,109,37,150,187,156,46,23,93,103,692
6,Grayson Allen,SG,26,MIL,66,61,1805,255,569,159,389,96,180,64,74,32,190,222,100,46,18,43,96,733
7,Jarrett Allen,C,23,CLE,56,56,1810,369,545,1,10,368,535,165,233,192,410,602,92,44,75,94,97,904
8,Jose Alvarado,PG,23,NOP,54,1,834,131,294,32,110,99,184,36,53,25,75,100,152,71,7,40,73,330
9,Justin Anderson,SF,28,TOT,16,6,316,36,95,15,59,21,36,15,19,4,42,46,33,8,6,8,22,102
10,Kyle Anderson,PF,28,MEM,69,11,1484,209,469,36,109,173,360,67,105,69,299,368,183,77,45,71,108,521
11,Giannis Antetokounmpo,PF,27,MIL,67,67,2204,689,1245,71,242,618,1003,553,766,134,644,778,388,72,91,219,212,2002
12,Thanasis Antetokounmpo,SF,29,MIL,48,6,473,70,128,2,14,68,114,29,46,40,61,101,22,16,12,26,68,171
13,Carmelo Anthony,PF,37,LAL,69,3,1793,319,723,149,397,170,326,132,159,62,226,288,68,47,52,59,166,919
14,Cole Anthony,PG,21,ORL,65,65,2059,357,912,132,391,225,521,216,253,32,316,348,369,46,17,170,171,1062
15,OG Anunoby,SF,24,TOR,48,48,1728,309,697,115,317,194,380,89,118,74,190,264,125,71,25,80,131,822
16,Ryan Arcidiacono,PG,27,NYK,10,0,76,6,12,4,9,2,3,0,0,0,8,8,4,1,0,3,5,16
17,Trevor Ariza,SF,36,LAL,24,11,462,33,99,20,74,13,25,10,18,10,72,82,27,13,6,11,20,96
18,D.J. Augustin,PG,34,TOT,55,2,883,94,222,68,164,26,58,38,43,11,57,68,107,17,1,56,39,294
19,Deni Avdija,SF,21,WAS,82,8,1984,250,579,82,259,168,320,103,136,52,373,425,167,59,44,87,190,685
20,Joel Ayayi,SG,21,WAS,7,0,20,1,6,0,1,1,5,0,0,1,2,3,4,0,0,0,0,2
21,Deandre Ayton,C,23,PHO,58,58,1713,442,697,7,19,435,678,106,142,149,444,593,84,40,40,91,142,997
22,Udoka Azubuike,C,22,UTA,17,6,195,37,49,0,0,37,49,6,11,18,53,71,0,1,11,12,25,80
23,Marvin Bagley III,PF,22,TOT,48,25,1153,225,446,23,97,202,349,67,101,105,233,338,36,22,18,39,93,540
24,LaMelo Ball,PG,20,CHO,75,75,2422,538,1254,220,565,318,689,212,243,108,393,501,571,119,30,245,237,1508
25,Lonzo Ball,PG,24,CHI,35,35,1212,162,383,110,260,52,123,21,28,35,155,190,178,64,31,82,85,455
26,Mo Bamba,C,23,ORL,71,69,1824,296,617,107,281,189,336,57,73,148,424,572,85,38,118,77,182,756
27,Desmond Bane,SG,23,MEM,76,76,2266,508,1101,228,523,280,578,140,155,46,288,334,208,92,29,111,196,1384
28,Dalano Banton,PG,22,TOR,64,1,696,83,202,13,51,70,151,26,44,38,86,124,99,28,10,53,68,205
29,Cat Barber,PG,27,ATL,3,0,13,0,4,0,0,0,4,0,4,1,2,3,3,0,0,1,1,0
30,Harrison Barnes,PF,29,SAC,77,77,2580,391,834,142,360,249,474,341,413,82,350,432,186,53,14,118,94,1265
31,Scottie Barnes,PF,20,TOR,74,74,2617,459,932,58,193,401,739,158,215,195,362,557,256,80,55,136,192,1134
32,RJ Barrett,SF,21,NYK,70,70,2417,487,1194,138,404,349,790,290,406,66,342,408,208,43,16,151,142,1402
33,Will Barton,SG,31,DEN,71,71,2277,392,896,157,430,235,466,102,127,44,296,340,276,55,31,127,114,1043
34,Paris Bass,SF,26,PHO,2,0,7,2,6,0,2,2,4,2,2,2,2,4,0,1,0,2,2,6
35,Charles Bassey,C,21,PHI,23,0,168,30,47,0,4,30,43,9,12,22,40,62,7,5,17,8,32,69
36,Keita Bates-Diop,SF,26,SAS,59,14,957,136,263,17,55,119,208,46,61,62,169,231,41,27,14,45,61,335
37,Nicolas Batum,PF,33,LAC,59,54,1463,179,387,108,270,71,117,25,38,29,225,254,100,58,42,40,80,491
38,Kent Bazemore,SF,32,LAL,39,14,545,45,139,29,80,16,59,13,17,13,56,69,34,25,9,21,70,132
39,Darius Bazley,PF,21,OKC,69,53,1924,274,649,80,269,194,380,117,170,71,365,436,97,58,70,90,68,745
40,Bradley Beal,SG,28,WAS,40,40,1439,348,771,63,210,285,561,169,203,38,151,189,265,36,15,135,95,928
41,Malik Beasley,SG,25,MIN,79,18,1976,332,850,240,637,92,213,49,60,26,201,227,116,43,12,43,88,953
42,Jordan Bell,C,27,CHI,1,0,2,0,0,0,0,0,0,0,0,1,0,1,0,1,0,0,2,0
43,DeAndre' Bembry,SF,27,TOT,56,20,1026,124,221,15,36,109,185,21,35,42,121,163,66,49,25,31,113,284
44,Dāvis Bertāns,PF,29,TOT,56,0,806,99,275,77,230,22,45,36,40,12,105,117,31,17,12,19,85,311
45,Patrick Beverley,PG,33,MIN,58,54,1476,177,436,83,242,94,194,96,133,62,178,240,268,67,52,73,174,533
46,Saddiq Bey,SF,22,DET,82,82,2704,450,1136,211,610,239,526,210,254,107,334,441,233,73,16,96,128,1321
47,Khem Birch,C,29,TOR,55,28,991,97,200,0,14,97,186,53,71,122,117,239,56,30,26,29,104,247
48,Goga Bitadze,C,22,IND,50,16,729,131,252,23,80,108,172,64,94,79,98,177,55,21,42,46,107,349
49,Bismack Biyombo,C,29,PHO,36,3,506,86,145,0,0,86,145,38,71,63,104,167,23,12,26,25,70,210
50,Nemanja Bjelica,C,33,GSW,71,0,1143,160,342,54,149,106,193,59,81,62,232,294,159,41,26,87,128,433
51,Eric Bledsoe,PG,32,LAC,54,29,1361,197,468,51,163,146,305,89,117,28,154,182,225,69,19,116,85,534
52,Keljin Blevins,SF,26,POR,31,1,349,34,111,21,72,13,39,6,11,16,29,45,19,13,1,17,29,95
53,Bogdan Bogdanović,SG,29,ATL,63,27,1848,342,794,169,459,173,335,97,115,29,221,250,194,68,14,70,132,950
54,Bojan Bogdanović,PF,32,UTA,69,69,2131,422,928,181,468,241,460,223,260,58,238,296,120,34,1,118,116,1248
55,Bol Bol,PF,22,DEN,14,0,81,15,27,1,4,14,23,2,5,4,16,20,5,1,2,4,4,33
56,Leandro Bolmaro,SF,21,MIN,35,2,241,17,54,5,18,12,36,11,13,16,27,43,21,6,0,13,26,50
57,Isaac Bonga,SF,22,TOR,15,0,69,3,13,1,4,2,9,5,8,4,3,7,4,8,2,2,10,12
58,Devin Booker,SG,25,PHO,68,68,2345,662,1421,183,478,479,943,315,363,45,297,342,329,77,26,162,180,1822
59,Brandon Boston Jr.,SG,20,LAC,51,0,760,125,325,34,111,91,214,59,72,17,94,111,51,26,13,31,43,343
60,Chris Boucher,SF,29,TOR,80,9,1690,268,577,68,229,200,348,150,193,179,315,494,25,49,75,42,174,754
61,James Bouknight,SG,21,CHO,31,0,304,49,141,17,49,32,92,27,31,22,30,52,26,7,1,15,29,142
62,Avery Bradley,SG,31,LAL,62,45,1406,148,350,82,210,66,140,16,18,31,105,136,47,53,9,38,118,394
63,Tony Bradley,C,24,CHI,55,7,549,72,123,0,0,72,123,19,29,67,119,186,27,10,33,34,62,163
64,Ignas Brazdeikis,SF,23,ORL,42,1,536,81,188,27,87,54,101,21,32,23,49,72,37,10,3,17,48,210
65,Mikal Bridges,SF,25,PHO,82,82,2854,458,858,115,312,343,546,131,157,74,273,347,185,96,36,68,150,1162
66,Miles Bridges,PF,23,CHO,80,80,2837,596,1214,154,465,442,749,267,333,90,469,559,300,74,67,150,193,1613
67,Oshae Brissett,SF,23,IND,67,25,1564,208,506,83,237,125,269,114,164,108,250,358,72,44,29,54,116,613
68,Malcolm Brogdon,PG,29,IND,36,36,1206,243,543,58,186,185,357,143,167,33,152,185,212,30,14,77,71,687
69,Armoni Brooks,SG-PG,23,TOT,54,11,844,98,289,74,249,24,40,18,21,20,83,103,62,28,11,27,74,288
70,Dillon Brooks,SF,26,MEM,32,31,885,227,526,46,149,181,377,90,106,29,73,102,88,36,8,50,105,590
71,Bruce Brown,SF,25,BRK,72,45,1774,256,506,38,94,218,412,97,128,100,245,345,148,77,52,56,176,647
72,Charlie Brown Jr.,SG,24,TOT,22,2,178,10,39,1,12,9,27,9,10,14,18,32,6,10,4,5,18,30
73,Chaundee Brown Jr.,SG-SF,23,TOT,5,2,104,10,32,6,18,4,14,5,6,1,15,16,4,2,0,1,7,31
74,Greg Brown III,SF,20,POR,48,6,640,81,190,19,61,62,129,44,65,38,97,135,35,26,24,36,90,225
75,Jaylen Brown,SF,25,BOS,66,66,2220,576,1217,166,464,410,753,241,318,53,351,404,231,70,18,178,163,1559
76,Moses Brown,C,22,TOT,40,6,344,64,108,0,0,64,108,43,72,39,96,135,1,7,16,20,53,171
77,Sterling Brown,SG,26,DAL,49,3,628,59,155,28,92,31,63,14,15,26,123,149,34,14,7,23,56,160
78,Troy Brown Jr.,SF,22,CHI,66,7,1055,108,258,47,133,61,125,20,26,39,164,203,66,36,5,26,62,283
79,Jalen Brunson,SG,25,DAL,79,61,2524,506,1008,94,252,412,756,179,213,43,266,309,377,66,3,124,151,1285
80,Thomas Bryant,C,24,WAS,27,9,439,77,148,12,42,65,106,35,40,26,82,108,23,6,21,19,43,201
81,Shaq Buchanan,SG,25,MEM,2,0,10,1,4,0,2,1,2,0,0,1,1,2,2,1,0,2,1,2
82,Reggie Bullock,SF,30,DAL,68,37,1902,201,501,141,392,60,109,40,48,33,208,241,83,41,14,40,111,583
83,Trey Burke,PG,29,DAL,42,0,441,84,215,26,82,58,133,20,23,4,29,33,57,12,0,26,39,214
84,Alec Burks,SG,30,NYK,81,44,2318,285,728,157,389,128,339,217,264,47,350,397,239,85,26,91,215,944
85,Jared Butler,SG,21,UTA,42,1,360,61,151,28,88,33,63,11,16,5,40,45,63,17,8,33,47,161
86,Jimmy Butler,SF,32,MIA,57,57,1931,398,829,27,116,371,713,396,455,102,234,336,312,94,27,121,88,1219
87,Devontae Cacok,PF,25,SAS,15,0,121,21,31,0,0,21,31,4,7,8,34,42,6,8,7,3,16,46
88,Kentavious Caldwell-Pope,SG,28,WAS,77,77,2329,361,829,159,408,202,421,137,154,41,220,261,145,83,26,97,139,1018
89,Facundo Campazzo,PG,30,DEN,65,4,1184,107,296,58,193,49,103,60,78,23,94,117,220,63,23,67,124,332
90,Vlatko Čančar,PF,24,DEN,15,1,176,23,41,7,12,16,29,9,14,8,23,31,17,2,3,9,18,62
91,Devin Cannady,PG,25,ORL,5,0,145,15,44,15,37,0,7,5,7,1,5,6,10,5,3,5,9,50
92,Clint Capela,C,27,ATL,74,73,2042,370,604,0,1,370,603,80,169,279,598,877,92,55,93,44,166,820
93,Vernon Carey Jr.,C,20,TOT,7,1,44,7,13,0,0,7,13,6,13,8,4,12,0,2,1,3,4,20
94,Jevon Carter,PG,26,TOT,66,3,905,98,253,66,170,32,83,15,18,14,96,110,96,24,14,34,67,277
95,Wendell Carter Jr.,PF,22,ORL,62,61,1852,359,684,70,214,289,470,143,207,139,509,648,171,36,43,117,169,931
96,Alex Caruso,SG,27,CHI,41,18,1147,102,256,42,126,60,130,58,73,33,115,148,165,71,15,57,106,304
97,Willie Cauley-Stein,C,28,TOT,20,2,183,16,35,1,2,15,33,1,2,13,27,40,10,6,3,7,19,34
98,Ahmad Caver,SG,25,IND,1,0,1,1,1,0,0,1,1,0,0,0,0,0,0,0,0,0,0,2
99,Justin Champagnie,SF,20,TOR,36,0,281,31,67,10,28,21,39,9,9,37,35,72,11,8,4,8,32,81
100,Zylan Cheatham,SF,26,UTA,1,0,5,0,3,0,2,0,1,0,0,0,0,0,0,0,0,0,0,0
101,Chris Chiozza,PG,26,GSW,34,1,372,24,81,17,53,7,28,2,3,9,27,36,65,13,0,32,32,67
102,Marquese Chriss,PF,24,DAL,34,0,346,62,134,8,25,54,109,22,33,33,70,103,17,13,12,17,64,154
103,Josh Christopher,SG,20,HOU,74,2,1334,224,500,56,189,168,311,83,113,52,134,186,150,65,13,114,97,587
104,Gary Clark,PF,27,NOP,38,1,378,33,88,28,70,5,18,7,10,23,67,90,18,13,7,10,20,101
105,Brandon Clarke,PF,25,MEM,64,1,1246,288,447,5,22,283,425,85,130,135,207,342,86,39,68,34,122,666
106,Jordan Clarkson,SG,29,UTA,79,1,2141,466,1113,190,597,276,516,144,174,67,206,273,194,66,16,129,149,1266
107,Nic Claxton,C,22,BRK,47,19,974,178,264,0,0,178,264,54,93,91,173,264,43,24,51,38,110,410
108,Amir Coffey,SG,24,LAC,69,30,1567,211,466,96,254,115,212,101,117,26,171,197,124,38,15,45,87,619
109,John Collins,PF,24,ATL,54,53,1663,339,644,64,176,275,468,134,169,93,329,422,98,33,56,60,164,876
110,Zach Collins,C,24,SAS,28,4,502,76,155,14,41,62,114,52,65,46,107,153,61,13,23,45,67,218
111,Darren Collison,PG,34,LAL,3,0,37,2,7,0,3,2,4,0,0,0,4,4,2,1,0,1,5,4
112,Mike Conley,PG,34,UTA,72,72,2058,344,791,169,414,175,377,129,162,47,170,217,385,96,21,123,142,986
113,Pat Connaughton,SF,29,MIL,65,19,1691,227,496,146,370,81,126,45,54,45,228,273,82,59,15,35,86,645
114,Tyler Cook,PF,24,CHI,20,2,200,23,38,0,0,23,38,21,32,16,37,53,3,4,4,7,28,67
115,Sharife Cooper,PG,20,ATL,13,0,39,3,14,1,6,2,8,0,0,0,5,5,5,0,0,5,1,7
116,Petr Cornelie,PF,26,DEN,13,0,38,5,15,1,8,4,7,3,4,7,7,14,3,1,1,4,7,14
117,DeMarcus Cousins,C,31,TOT,48,7,717,149,324,37,122,112,202,95,125,74,196,270,71,35,21,85,139,430
118,Robert Covington,PF,31,TOT,71,42,1939,209,498,128,339,81,159,58,69,59,332,391,92,103,91,75,190,604
119,Torrey Craig,SF,31,TOT,78,16,1596,200,441,77,234,123,207,39,52,86,224,310,91,46,36,67,151,516
120,Jae Crowder,PF,31,PHO,67,67,1886,217,544,127,365,90,179,71,90,30,324,354,124,95,30,55,173,632
121,Jarrett Culver,SG,22,MEM,37,0,338,51,135,12,47,39,88,16,34,13,35,48,33,20,5,20,42,130
122,Jarron Cumberland,SG,24,POR,3,0,12,1,2,0,1,1,1,0,0,1,2,3,1,0,0,0,2,2
123,Cade Cunningham,SG,20,DET,64,64,2088,429,1031,114,363,315,668,142,168,58,296,354,356,78,43,234,200,1114
124,Seth Curry,SG,31,TOT,64,64,2134,360,739,158,374,202,365,82,94,21,179,200,230,53,14,109,148,960
125,Stephen Curry,PG,33,GSW,64,64,2211,535,1224,285,750,250,474,275,298,34,301,335,404,85,23,206,130,1630
126,Anthony Davis,C,28,LAL,40,40,1404,370,695,13,70,357,625,174,244,106,288,394,122,49,90,82,97,927
127,Ed Davis,C,32,CLE,31,3,201,11,16,0,0,11,16,6,14,14,50,64,7,3,9,5,33,28
128,Terence Davis,SG,24,SAC,30,11,536,113,267,49,149,64,118,36,44,11,83,94,40,25,11,33,70,311
129,Gabriel Deck,PF,26,OKC,7,0,56,8,14,2,4,6,10,0,0,1,5,6,5,1,0,2,2,18
130,Dewayne Dedmon,C,32,MIA,67,15,1065,164,290,19,47,145,243,75,100,105,281,386,47,24,42,70,174,422
131,Sam Dekker,PF,27,TOR,1,0,1,0,0,0,0,0,0,0,0,0,0,0,0,0,0,0,0,0
132,Javin DeLaurier,C,23,MIL,1,0,3,0,0,0,0,0,0,0,0,0,1,1,0,1,0,0,1,0
133,DeMar DeRozan,PF,32,CHI,76,76,2743,774,1535,50,142,724,1393,520,593,56,336,392,374,68,24,181,178,2118
134,Mamadi Diakite,PF,25,OKC,13,3,188,25,47,0,5,25,42,6,11,17,42,59,2,5,9,7,33,56
135,Cheick Diallo,C,25,DET,3,0,31,3,8,0,0,3,8,5,6,4,8,12,0,1,0,1,6,11
136,Hamidou Diallo,SG,23,DET,58,29,1269,261,526,23,93,238,433,91,140,69,208,277,73,71,17,58,143,636
137,Gorgui Dieng,C,32,ATL,44,3,371,53,112,29,68,24,44,19,26,32,89,121,34,11,13,20,52,154
138,Spencer Dinwiddie,PG,28,TOT,67,51,1980,306,735,112,330,194,405,195,252,45,234,279,346,44,13,104,150,919
139,Donte DiVincenzo,SG,25,TOT,42,1,1005,118,336,74,218,44,118,70,83,40,130,170,118,48,8,72,69,380
140,Luka Dončić,PG,22,DAL,65,65,2301,641,1403,201,569,440,834,364,489,56,537,593,568,75,36,292,145,1847
141,Luguentz Dort,SG,22,OKC,51,51,1665,293,726,130,391,163,335,161,191,38,174,212,88,46,18,88,149,877
142,Ayo Dosunmu,SG,22,CHI,77,40,2110,278,535,70,186,208,349,53,78,27,187,214,256,60,29,108,182,679
143,Damyean Dotson,SG,27,NYK,2,0,21,2,4,0,1,2,3,0,0,0,2,2,1,0,0,0,0,4
144,Devon Dotson,PG,22,CHI,11,0,85,11,23,2,9,9,14,5,9,1,8,9,15,1,0,5,11,29
145,Sekou Doumbouya,PF,21,LAL,2,0,16,5,8,1,2,4,6,3,4,2,4,6,0,3,2,2,1,14
146,Jeff Dowtin,PG,24,TOT,9,0,108,8,26,1,9,7,17,2,2,8,10,18,10,5,1,5,5,19
147,PJ Dozier,SG,25,DEN,18,0,340,36,99,15,48,21,51,10,13,14,49,63,29,11,6,13,33,97
148,Goran Dragić,PG,35,TOT,21,8,497,57,151,16,63,41,88,27,33,13,52,65,86,19,4,34,45,157
149,Andre Drummond,C,28,TOT,73,36,1437,247,433,0,3,247,430,86,164,229,451,680,131,78,68,115,192,580
150,Chris Duarte,SG,24,IND,55,39,1541,268,621,94,255,174,366,90,112,41,185,226,114,56,10,90,95,720
151,David Duke Jr.,PG,22,BRK,22,7,341,39,108,9,37,30,71,17,21,30,37,67,17,14,7,9,36,104
152,Kris Dunn,PG,27,POR,14,3,336,44,102,1,11,43,91,17,18,9,40,49,79,23,3,32,38,106
153,Kevin Durant,PF,33,BRK,55,55,2047,578,1115,115,300,463,815,372,409,29,378,407,351,48,52,191,113,1643
154,Jaime Echenique,C,24,WAS,1,0,3,0,0,0,0,0,0,0,0,0,0,0,0,0,0,0,0,0
155,Anthony Edwards,SG,20,MIN,72,72,2466,549,1245,215,602,334,643,220,280,62,281,343,275,105,46,190,164,1533
156,Carsen Edwards,SG,23,DET,4,0,79,9,30,4,16,5,14,1,1,2,4,6,14,2,0,5,4,23
157,Kessler Edwards,SF,21,BRK,48,23,987,110,267,48,136,62,131,16,19,44,128,172,31,29,24,42,85,284
158,Rob Edwards,SG,25,OKC,2,0,11,1,4,1,4,0,0,0,0,0,3,3,0,0,0,1,0,3
159,CJ Elleby,SF,21,POR,58,28,1174,121,308,37,126,84,182,60,84,66,161,227,87,35,19,56,116,339
160,Wayne Ellington,SG,34,LAL,43,9,810,98,237,82,211,16,26,9,11,10,67,77,30,23,5,19,42,287
161,Joel Embiid,C,27,PHI,68,68,2297,666,1334,93,251,573,1083,654,803,146,650,796,284,77,99,214,181,2079
162,James Ennis III,SF,31,TOT,7,0,56,11,24,3,8,8,16,4,5,5,7,12,3,2,2,2,5,29
163,Drew Eubanks,C,24,TOT,71,31,1245,221,371,5,23,216,348,99,130,130,252,382,85,31,40,81,122,546
164,Tacko Fall,C,26,CLE,11,1,59,5,12,0,0,5,12,2,7,7,16,23,2,0,6,3,3,12
165,Derrick Favors,C,30,OKC,39,18,653,94,182,2,16,92,166,16,25,58,126,184,25,17,12,9,62,206
166,Bruno Fernando,C,23,TOT,30,0,153,36,55,1,2,35,53,15,24,18,37,55,7,1,11,14,24,88
167,Dorian Finney-Smith,PF,28,DAL,80,80,2644,326,692,172,435,154,257,56,83,122,253,375,150,88,39,80,183,880
168,Malik Fitts,PF,24,TOT,15,0,63,8,19,5,10,3,9,0,0,2,15,17,5,0,0,2,4,21
169,Malachi Flynn,PG,23,TOR,44,5,537,72,183,30,90,42,93,15,24,10,53,63,70,20,4,13,45,189
170,Bryn Forbes,SG,28,TOT,75,2,1286,231,539,122,295,109,244,79,87,10,83,93,75,25,5,56,95,663
171,Aleem Ford,SF,24,ORL,5,0,74,6,20,2,15,4,5,0,0,2,13,15,2,1,0,4,7,14
172,Trent Forrest,PG,23,UTA,60,6,765,76,155,5,27,71,128,38,48,23,76,99,106,30,6,48,43,195
173,Evan Fournier,SG,29,NYK,80,80,2358,402,965,241,619,161,346,80,113,34,176,210,171,79,20,105,180,1125
174,De'Aaron Fox,PG,24,SAC,59,59,2084,516,1092,74,249,442,843,261,348,25,206,231,330,68,25,168,172,1367
175,Melvin Frazier,SG,25,OKC,3,0,120,13,48,1,21,12,27,5,7,5,8,13,1,1,0,3,8,32
176,Tim Frazier,PG,31,TOT,12,3,208,14,45,6,17,8,28,5,9,5,14,19,34,3,1,15,27,39
177,Enes Freedom,C,29,BOS,35,1,411,51,97,2,5,49,92,24,28,61,99,160,8,5,14,20,42,128
178,Markelle Fultz,PG,23,ORL,18,3,360,83,175,4,17,79,158,25,31,4,45,49,99,20,5,40,22,195
179,Wenyen Gabriel,PF,24,TOT,26,5,359,54,110,8,28,46,82,25,42,39,58,97,14,5,11,16,68,141
180,Daniel Gafford,C,23,WAS,72,53,1444,285,411,0,1,285,410,107,153,155,252,407,68,30,99,65,170,677
181,Danilo Gallinari,PF,33,ATL,66,18,1672,259,597,112,294,147,303,141,156,35,273,308,101,28,12,38,93,771
182,Langston Galloway,SG,30,TOT,7,0,107,6,26,2,16,4,10,0,0,3,15,18,12,1,0,6,7,14
183,Darius Garland,PG,22,CLE,68,68,2430,542,1173,174,454,368,719,215,241,39,185,224,583,89,7,248,115,1473
184,Marcus Garrett,SG,23,MIA,12,0,128,5,21,1,4,4,17,2,5,9,14,23,7,5,3,2,16,13
185,Usman Garuba,PF,19,HOU,24,2,240,19,44,5,20,14,24,5,7,21,62,83,17,10,11,6,28,48
186,Luka Garza,C,23,DET,32,5,389,66,147,16,49,50,98,38,61,58,42,100,20,9,6,18,55,186
187,Rudy Gay,PF,35,UTA,55,1,1038,157,379,70,203,87,176,62,79,55,187,242,56,25,19,47,95,446
188,Paul George,PF,31,LAC,31,31,1077,268,636,91,257,177,379,127,148,12,201,213,176,67,13,126,74,754
189,Taj Gibson,C,36,NYK,52,4,946,86,166,15,38,71,128,42,52,88,141,229,32,22,40,27,137,229
190,Josh Giddey,SF,19,OKC,54,54,1700,281,670,56,213,225,457,56,79,98,323,421,345,51,20,171,88,674
191,Shai Gilgeous-Alexander,PG,23,OKC,56,56,1942,477,1052,89,297,388,755,328,405,37,241,278,331,71,46,154,142,1371
192,Anthony Gill,PF,29,WAS,44,0,463,62,109,14,26,48,83,42,52,33,52,85,27,5,11,18,58,180
193,Freddie Gillespie,PF,24,ORL,9,2,119,9,22,0,1,9,21,3,7,13,23,36,5,3,9,5,18,21
194,Rudy Gobert,C,29,UTA,66,66,2120,362,508,0,4,362,504,303,439,241,727,968,72,45,137,119,176,1027
195,Brandon Goodwin,PG,26,CLE,36,5,502,64,154,19,55,45,99,24,38,14,53,67,91,25,1,36,39,171
196,Jordan Goodwin,SG,23,WAS,2,0,6,0,3,0,1,0,2,0,0,0,1,1,0,0,0,0,1,0
197,Aaron Gordon,PF,26,DEN,75,75,2376,434,834,87,260,347,574,171,230,125,314,439,188,44,44,133,148,1126
198,Eric Gordon,SG,33,HOU,57,46,1670,268,564,124,301,144,263,105,135,15,98,113,154,28,18,107,63,765
199,Devonte' Graham,PG,26,NOP,76,63,2162,296,815,192,563,104,252,118,140,37,140,177,316,71,12,105,95,902
200,Jerami Grant,PF,27,DET,47,47,1500,298,699,91,254,207,445,217,259,28,163,191,111,44,49,85,107,904
201,Hassani Gravett,PG,25,ORL,8,3,171,18,38,11,26,7,12,3,4,1,20,21,20,5,1,9,13,50
202,Danny Green,SF,34,PHI,62,28,1353,126,320,103,271,23,49,11,14,32,125,157,64,60,37,45,105,366
203,Draymond Green,PF,31,GSW,46,44,1329,135,257,16,54,119,203,60,91,45,291,336,320,61,50,139,136,346
204,Jalen Green,SG,19,HOU,67,67,2138,406,954,157,458,249,496,188,236,33,193,226,176,44,18,135,103,1157
205,JaMychal Green,PF,31,DEN,67,8,1085,159,327,33,124,126,203,81,93,81,200,281,59,43,26,57,158,432
206,Javonte Green,SF,28,CHI,65,45,1519,176,325,36,101,140,224,80,96,91,185,276,60,67,32,30,132,468
207,Jeff Green,PF,35,DEN,75,63,1849,277,529,53,168,224,361,165,198,41,190,231,96,28,27,71,151,772
208,Josh Green,SG,21,DAL,67,3,1039,130,256,28,78,102,178,31,45,52,109,161,79,45,14,44,115,319
209,Blake Griffin,C,32,BRK,56,24,958,133,313,38,145,95,168,55,76,60,168,228,105,27,14,31,95,359
210,Quentin Grimes,SG,21,NYK,46,6,786,95,235,72,189,23,46,13,19,24,70,94,44,31,11,28,72,275
211,Kyle Guy,SG,24,MIA,19,0,186,26,65,14,40,12,25,8,12,4,13,17,17,7,1,13,12,74
212,Rui Hachimura,PF,23,WAS,42,13,943,187,381,55,123,132,258,46,66,25,135,160,48,23,9,33,53,475
213,Tyrese Haliburton,SG-PG,21,TOT,77,77,2694,430,909,161,389,269,520,160,190,61,250,311,628,134,49,199,121,1181
214,Tyler Hall,SG,24,NYK,1,0,2,0,0,0,0,0,0,0,0,0,0,0,0,0,0,0,0,0
215,R.J. Hampton,SG,20,ORL,64,14,1402,175,457,64,183,111,274,75,117,23,171,194,158,42,13,87,101,489
216,Tim Hardaway Jr.,SG,29,DAL,42,20,1245,209,530,102,304,107,226,78,103,13,143,156,92,38,6,34,74,598
217,James Harden,PG,32,TOT,65,65,2420,407,992,148,448,259,544,470,536,55,445,500,667,82,36,284,153,1432
218,Maurice Harkless,SF,28,SAC,47,24,863,83,181,31,101,52,80,20,28,12,100,112,23,29,24,31,77,217
219,Jared Harper,PG,24,NOP,5,0,43,14,26,5,12,9,14,4,4,2,0,2,14,4,1,2,5,37
220,Montrezl Harrell,C,28,TOT,71,3,1640,358,555,4,17,354,538,212,296,149,282,431,145,29,43,72,137,932
221,Gary Harris,SG,27,ORL,61,30,1730,240,553,116,302,124,251,83,95,36,86,122,108,59,9,61,112,679
222,Joe Harris,SF,30,BRK,14,14,423,56,124,41,88,15,36,5,6,5,51,56,14,7,2,16,31,158
223,Tobias Harris,PF,29,PHI,73,73,2543,493,1022,101,275,392,747,170,202,77,419,496,252,47,43,116,164,1257
224,Shaquille Harrison,SG,28,BRK,2,0,23,2,6,0,2,2,4,0,0,1,3,4,3,1,1,2,3,4
225,Josh Hart,SG,26,TOT,54,53,1791,287,569,73,213,214,356,160,211,62,326,388,224,61,13,114,150,807
226,Isaiah Hartenstein,C,23,LAC,68,0,1216,229,366,14,30,215,336,91,132,117,215,332,160,50,77,84,167,563
227,Udonis Haslem,C,41,MIA,13,0,83,14,31,1,4,13,27,3,3,4,21,25,4,1,1,5,15,32
228,Sam Hauser,SF,24,BOS,26,0,158,23,50,19,44,4,6,0,0,5,24,29,10,1,2,2,7,65
229,Jaxson Hayes,C,21,NOP,70,28,1398,245,398,20,57,225,341,144,188,115,200,315,43,33,55,54,155,654
230,Killian Hayes,PG,20,DET,66,40,1647,176,459,44,167,132,292,57,74,36,174,210,277,78,35,111,183,453
231,Gordon Hayward,SF,31,CHO,49,48,1564,283,617,86,220,197,397,126,149,38,186,224,177,47,22,81,85,778
232,Aaron Henry,SF,22,PHI,6,0,17,1,5,0,1,1,4,0,0,0,1,1,0,0,2,2,2,2
233,Juancho Hernangómez,PF,26,TOT,40,9,445,44,106,24,69,20,37,19,34,28,72,100,20,14,10,16,25,131
234,Willy Hernangómez,C,27,NOP,50,8,839,170,327,4,12,166,315,109,141,143,195,338,63,21,19,51,97,453
235,Tyler Herro,SG,22,MIA,66,10,2151,501,1122,175,439,326,683,190,219,32,297,329,263,44,8,174,95,1367
236,Buddy Hield,SG,29,TOT,81,32,2499,446,1098,262,716,184,382,111,127,66,287,353,229,73,25,153,184,1265
237,Haywood Highsmith,SF,25,MIA,19,1,163,16,46,9,28,7,18,2,5,10,16,26,6,2,3,3,13,43
238,George Hill,PG,35,MIL,54,17,1253,118,275,41,134,77,141,57,62,38,117,155,120,42,6,41,70,334
239,Malcolm Hill,SF-SG,26,TOT,19,0,212,24,52,13,36,11,16,11,14,11,24,35,8,7,3,3,24,72
240,Solomon Hill,SF,30,ATL,13,1,139,3,20,2,13,1,7,0,0,6,17,23,12,4,2,1,16,8
241,Nate Hinton,SG,22,IND,2,0,2,0,1,0,0,0,1,0,0,0,0,0,0,0,0,1,0,0
242,Jaylen Hoard,SF,22,OKC,7,5,240,44,90,9,25,35,65,6,14,30,54,84,17,6,5,8,14,103
243,Aaron Holiday,PG,25,TOT,63,15,1021,151,338,39,103,112,235,59,68,24,98,122,153,42,9,67,92,400
244,Jrue Holiday,PG,31,MIL,67,64,2208,478,954,132,321,346,633,137,180,69,232,301,457,108,29,183,133,1225
245,Justin Holiday,SF-SG,32,TOT,74,65,2057,261,662,177,482,84,180,50,62,29,161,190,128,57,33,70,154,749
246,Richaun Holmes,C,28,SAC,45,37,1074,198,300,2,5,196,295,70,90,93,224,317,48,17,41,56,128,468
247,Rodney Hood,PF-SF,29,TOT,52,0,709,58,157,30,91,28,66,17,19,15,62,77,38,15,6,11,31,163
248,Scotty Hopson,SG,32,OKC,1,0,18,2,4,0,1,2,3,0,0,0,1,1,1,0,0,2,1,4
249,Al Horford,C,35,BOS,69,69,2005,266,569,89,265,177,304,80,95,108,422,530,232,49,92,65,130,701
250,Talen Horton-Tucker,SG,21,LAL,60,19,1511,224,538,49,182,175,356,100,125,37,156,193,159,59,29,82,148,597
251,Danuel House Jr.,SF,28,TOT,42,7,727,80,198,44,117,36,81,44,58,18,93,111,44,21,17,33,51,248
252,Dwight Howard,C,36,LAL,60,27,971,134,219,8,15,126,204,96,146,118,238,356,35,34,36,47,115,372
253,Markus Howard,SG,22,DEN,31,0,176,39,101,28,70,11,31,20,23,2,10,12,7,9,0,7,17,126
254,Kevin Huerter,SF,23,ATL,74,60,2188,345,760,160,411,185,349,42,52,32,222,254,203,55,26,91,185,892
255,Jay Huff,C,23,LAL,4,0,20,0,3,0,2,0,1,0,0,1,3,4,1,1,1,1,1,0
256,Elijah Hughes,SG-SF,23,TOT,36,4,434,47,144,25,95,22,49,7,9,6,52,58,22,14,8,17,39,126
257,Feron Hunt,SF,22,NYK,2,0,8,0,2,0,0,0,2,0,0,1,0,1,1,1,0,1,1,0
258,De'Andre Hunter,SF,24,ATL,53,52,1577,254,575,74,195,180,380,127,166,26,150,176,68,36,21,69,155,709
259,Chandler Hutchison,SF,25,PHO,6,0,22,1,2,0,0,1,2,2,2,0,5,5,2,0,0,4,1,4
260,Bones Hyland,SG,21,DEN,69,4,1310,230,571,131,358,99,213,107,125,14,174,188,191,41,20,86,153,698
261,Serge Ibaka,C,32,TOT,54,12,878,148,296,37,99,111,197,32,44,62,188,250,49,11,33,43,102,365
262,Andre Iguodala,SF,38,GSW,31,0,603,46,121,17,74,29,47,15,20,21,79,100,114,27,22,28,34,124
263,Joe Ingles,SF,34,UTA,45,15,1122,115,285,78,225,37,60,17,22,12,119,131,158,23,5,46,82,325
264,Brandon Ingram,SF,24,NOP,55,55,1869,453,983,74,226,379,757,266,322,35,285,320,307,34,26,151,119,1246
265,Kyrie Irving,PG,29,BRK,29,29,1091,289,616,100,239,189,377,118,129,16,111,127,167,41,17,73,81,796
266,Wes Iwundu,SF,27,ATL,3,1,82,8,18,3,5,5,13,3,4,3,10,13,0,1,0,1,8,22
267,Frank Jackson,PG,23,DET,53,7,1164,194,483,86,279,108,204,86,104,19,68,87,55,27,9,38,89,560
268,Isaiah Jackson,C,20,IND,36,15,541,116,206,5,16,111,190,60,88,60,89,149,10,25,52,40,92,297
269,Jaren Jackson Jr.,PF,22,MEM,78,78,2126,430,1036,128,401,302,635,284,345,119,335,454,86,73,177,130,272,1272
270,Josh Jackson,SF,24,TOT,51,3,830,120,300,33,130,87,170,55,77,21,120,141,54,26,22,47,88,328
271,Justin Jackson,SF,26,TOT,7,0,36,5,15,3,9,2,6,2,2,1,6,7,2,0,0,1,3,15
272,Reggie Jackson,SG,31,LAC,75,75,2337,479,1222,167,512,312,710,138,163,39,232,271,359,55,15,173,159,1263
273,LeBron James,C,37,LAL,56,56,2084,640,1221,161,448,479,773,254,336,63,396,459,349,73,59,196,121,1695
274,DeJon Jarreau,SG,24,IND,1,0,1,0,0,0,0,0,0,0,0,0,0,0,0,0,0,0,0,0
275,DaQuan Jeffries,SG,24,MEM,3,0,9,1,2,0,1,1,1,0,0,0,2,2,1,0,0,0,1,2
276,Ty Jerome,SG,24,OKC,48,4,801,124,328,54,186,70,142,38,47,19,59,78,109,30,5,37,73,340
277,Isaiah Joe,SG,22,PHI,55,1,609,62,177,45,135,17,42,29,31,6,50,56,35,14,3,19,47,198
278,Alize Johnson,PF,25,TOT,23,0,167,17,39,0,4,17,35,7,12,28,33,61,9,5,0,12,18,41
279,B.J. Johnson,SF,26,ORL,4,0,65,11,25,4,10,7,15,0,0,6,9,15,0,0,1,0,4,26
280,Cameron Johnson,PF,25,PHO,66,16,1730,279,607,166,391,113,216,98,114,42,231,273,99,57,16,47,113,822
281,David Johnson,SG,20,TOR,2,0,2,0,1,0,1,0,0,0,0,0,0,0,0,0,0,0,0,0
282,Jalen Johnson,PF,20,ATL,22,0,120,22,41,3,13,19,28,5,7,2,24,26,3,3,2,9,9,52
283,James Johnson,PF,34,BRK,62,10,1191,144,307,23,85,121,222,29,55,51,164,215,130,30,34,48,162,340
284,Joe Johnson,SG,40,BOS,1,0,2,1,1,0,0,1,1,0,0,0,0,0,0,0,0,0,0,2
285,Keldon Johnson,SF,22,SAS,75,74,2392,471,1011,159,399,312,612,177,234,80,377,457,158,58,14,92,148,1278
286,Keon Johnson,SG,19,TOT,37,12,696,96,272,34,100,62,172,41,51,24,57,81,76,28,12,46,69,267
287,Stanley Johnson,PF,25,LAL,48,27,1094,117,251,33,105,84,146,53,74,34,121,155,80,43,14,35,109,320
288,Tyler Johnson,PG,29,TOT,6,0,91,6,20,5,13,1,7,0,0,3,9,12,7,3,3,2,7,17
289,Nikola Jokić,C,26,DEN,74,74,2476,764,1311,97,288,667,1023,379,468,206,813,1019,584,109,63,281,191,2004
290,Carlik Jones,PG,24,TOT,5,0,23,1,9,0,1,1,8,2,2,1,2,3,5,1,0,3,0,4
291,Damian Jones,C,26,SAC,56,15,1017,175,266,10,29,165,237,94,131,75,171,246,69,26,47,59,130,454
292,Derrick Jones Jr.,PF,24,CHI,51,8,899,105,195,20,61,85,134,56,70,60,109,169,30,25,33,30,105,286
293,Herbert Jones,PF,23,NOP,78,69,2335,274,576,57,169,217,407,137,163,98,198,296,167,130,60,100,238,742
294,Jemerrio Jones,SF,26,LAL,2,0,15,2,3,0,0,2,3,0,0,2,1,3,0,1,0,0,2,4
295,Kai Jones,C,21,CHO,21,0,63,9,14,1,2,8,12,3,8,3,8,11,4,1,2,6,8,22
296,Mason Jones,SG,23,LAL,4,0,51,7,15,1,4,6,11,12,15,1,9,10,4,2,0,1,8,27
297,Tre Jones,PG,22,SAS,69,11,1148,166,339,10,51,156,288,71,91,29,126,155,233,42,7,46,78,413
298,Tyus Jones,PG,25,MEM,73,23,1549,249,552,80,205,169,347,54,66,17,159,176,324,66,2,46,32,632
299,DeAndre Jordan,C,33,TOT,48,20,622,92,143,0,0,92,143,22,40,83,181,264,21,12,35,37,71,206
300,Cory Joseph,PG,30,DET,65,39,1600,178,400,65,157,113,243,100,113,29,145,174,237,42,17,85,147,521
301,Georgios Kalaitzakis,SF,23,TOT,13,4,213,31,67,10,26,21,41,14,30,6,15,21,12,11,2,20,19,86
302,Frank Kaminsky,C,28,PHO,9,0,181,36,66,5,15,31,51,18,20,11,30,41,13,8,7,5,14,95
303,Luke Kennard,SG,25,LAC,70,13,1919,287,639,190,423,97,216,69,77,20,209,229,146,42,6,60,101,833
304,Braxton Key,SF,24,TOT,11,0,197,33,72,6,21,27,51,7,13,13,37,50,11,10,11,11,26,79
305,George King,SF,28,DAL,4,0,19,0,5,0,4,0,1,1,2,0,5,5,0,0,0,1,4,1
306,Louis King,SF,22,SAC,10,0,104,15,47,8,27,7,20,7,10,0,12,12,9,2,1,0,14,45
307,Corey Kispert,SF,22,WAS,77,36,1801,234,514,112,320,122,194,54,62,53,156,209,85,35,22,50,93,634
308,Maxi Kleber,PF,30,DAL,59,21,1450,141,354,83,255,58,99,46,65,70,280,350,68,30,58,47,137,411
309,Brandon Knight,PG,30,DAL,5,0,65,10,25,4,17,6,8,8,8,0,8,8,8,1,0,4,5,32
310,Nathan Knight,PF,24,MIN,37,2,267,45,88,4,13,41,75,44,60,32,53,85,22,7,8,18,42,138
311,Kevin Knox,SF,22,TOT,30,0,222,31,85,15,54,16,31,16,22,14,30,44,10,4,2,7,19,93
312,John Konchar,SG,25,MEM,72,7,1292,135,262,52,126,83,136,27,49,87,242,329,109,45,22,29,90,349
313,Furkan Korkmaz,SG,24,PHI,67,19,1414,182,470,77,266,105,204,68,84,22,153,175,127,33,9,48,58,509
314,Luke Kornet,C,26,TOT,15,0,103,13,27,0,5,13,22,4,6,13,16,29,9,3,3,0,9,30
315,Vit Krejci,SG,21,OKC,30,8,690,68,167,32,98,36,69,19,22,18,83,101,57,19,8,29,65,187
316,Arnoldas Kulboka,SF,24,CHO,2,0,5,0,1,0,1,0,0,0,0,0,0,0,0,0,0,0,1,0
317,Jonathan Kuminga,SF,19,GSW,70,12,1185,236,460,50,149,186,311,130,190,54,180,234,64,31,22,74,146,652
318,Kyle Kuzma,PF,26,WAS,66,66,2204,423,936,128,375,295,561,156,219,70,491,561,233,42,57,169,128,1130
319,Anthony Lamb,SF,24,SAS,2,0,8,0,2,0,2,0,0,0,0,0,1,1,2,0,0,0,0,0
320,Jeremy Lamb,SF-SG,29,TOT,56,0,935,133,347,55,170,78,177,89,106,26,128,154,81,31,22,37,59,410
321,Jock Landale,C,26,SAS,54,1,589,101,204,29,89,72,115,34,41,63,75,138,45,10,14,31,53,265
322,Romeo Langford,SG,22,TOT,48,5,771,83,191,29,85,54,106,23,42,30,78,108,21,22,16,16,47,218
323,Zach LaVine,SG,26,CHI,67,67,2328,565,1186,185,475,380,711,320,375,22,286,308,303,41,23,171,120,1635
324,Jake Layman,SF,27,MIN,34,1,231,30,73,8,35,22,38,13,18,6,30,36,9,7,5,10,12,81
325,Damion Lee,SG,29,GSW,63,5,1256,169,383,63,187,106,196,66,75,27,176,203,63,39,6,38,95,467
326,Saben Lee,PG,22,DET,37,0,604,69,177,14,60,55,117,56,71,18,69,87,107,36,12,36,44,208
327,Alex Len,C,28,SAC,39,10,620,94,176,6,21,88,155,41,63,52,109,161,45,13,25,43,100,235
328,Caris LeVert,SG,27,TOT,58,49,1780,379,854,82,256,297,598,146,193,43,171,214,248,51,23,108,131,986
329,Kira Lewis Jr.,PG,20,NOP,24,0,341,59,146,13,58,46,88,10,12,9,30,39,49,11,1,26,17,141
330,Scottie Lewis,SG,21,CHO,2,0,7,0,0,0,0,0,0,1,2,0,0,0,1,1,0,0,0,1
331,Damian Lillard,PG,31,POR,29,29,1056,222,552,92,284,130,268,159,181,13,107,120,212,17,11,83,37,695
332,Nassir Little,SF,21,POR,42,23,1088,145,315,51,154,94,161,69,94,58,178,236,54,25,36,40,82,410
333,Isaiah Livers,SF,23,DET,19,5,383,41,90,27,64,14,26,12,14,15,42,57,21,13,7,15,37,121
334,Kevon Looney,C,25,GSW,82,80,1732,208,364,0,1,208,363,75,125,208,388,596,165,50,52,67,215,491
335,Brook Lopez,C,33,MIL,13,11,298,61,131,19,53,42,78,20,23,19,34,53,6,8,15,12,34,161
336,Robin Lopez,C,33,ORL,36,9,612,110,199,2,6,108,193,32,54,68,58,126,54,2,18,44,67,254
337,Didi Louzada,SG-SF,22,TOT,9,1,129,12,33,9,23,3,10,2,2,5,12,17,5,2,2,5,13,35
338,Kevin Love,C,33,CLE,74,4,1665,327,761,187,477,140,284,166,198,87,449,536,160,26,18,98,101,1007
339,Kyle Lowry,PG,35,MIA,63,63,2133,276,627,144,382,132,245,148,174,33,249,282,474,67,17,168,177,844
340,Gabriel Lundberg,SG,27,PHO,4,0,44,5,19,3,8,2,11,0,0,2,5,7,11,3,0,3,7,13
341,Timothé Luwawu-Cabarrot,SF,26,ATL,52,18,685,74,186,44,122,30,64,35,41,17,65,82,40,18,6,20,76,227
342,Trey Lyles,PF,26,TOT,75,23,1536,262,562,67,209,195,353,195,243,89,290,379,88,29,32,73,123,786
343,Théo Maledon,PG,20,OKC,51,7,908,119,317,44,150,75,167,79,100,20,111,131,111,31,11,65,67,361
344,Sandro Mamukelashvili,PF,22,MIL,41,3,407,57,115,22,52,35,63,18,22,35,47,82,22,9,9,15,28,154
345,Terance Mann,SF,25,LAC,81,33,2317,334,690,76,208,258,482,128,164,104,321,425,209,55,21,84,178,872
346,Tre Mann,PG,20,OKC,60,26,1367,231,588,98,272,133,316,65,82,25,146,171,91,47,12,71,102,625
347,Boban Marjanović,C,33,DAL,23,0,128,42,70,1,4,41,66,13,22,8,31,39,3,0,3,15,24,98
348,Lauri Markkanen,SF,24,CLE,61,61,1878,313,703,136,380,177,323,138,159,59,286,345,81,45,30,54,130,900
349,Naji Marshall,SF,24,NOP,55,4,735,109,269,21,105,88,164,74,93,38,104,142,62,33,8,46,69,313
350,Caleb Martin,SF,26,MIA,60,12,1372,208,410,64,155,144,255,71,93,70,160,230,64,58,30,52,104,551
351,Cody Martin,SF,26,CHO,71,11,1866,204,423,61,159,143,264,75,107,82,203,285,179,88,32,61,116,544
352,Kelan Martin,SF,26,TOT,30,1,450,70,171,22,75,48,96,9,13,17,38,55,21,13,9,14,36,171
353,Kenyon Martin Jr.,SF,21,HOU,79,2,1656,279,523,60,168,219,355,78,123,80,217,297,101,34,40,60,113,696
354,Garrison Mathews,SG,25,HOU,65,33,1712,184,461,139,386,45,75,143,180,32,158,190,64,57,24,41,168,650
355,Dakota Mathias,SG,26,MEM,6,0,16,2,6,2,6,0,0,0,0,0,2,2,1,1,0,0,1,6
356,Wesley Matthews,SG,35,MIL,49,14,1002,87,220,53,157,34,63,22,28,30,62,92,36,23,8,18,87,249
357,Tyrese Maxey,PG,21,PHI,75,74,2650,483,995,132,309,351,686,213,246,26,214,240,321,55,32,88,156,1311
358,Skylar Mays,SG,24,ATL,28,5,220,32,64,8,25,24,39,8,9,5,20,25,17,7,0,10,9,80
359,Miles McBride,PG,21,NYK,40,2,372,32,108,17,68,15,40,8,12,4,38,42,41,14,1,5,45,89
360,Mac McClung,SG-PG,23,TOT,2,0,24,3,6,1,3,2,3,1,1,0,3,3,1,1,1,3,5,8
361,CJ McCollum,SG,30,TOT,62,62,2145,536,1164,182,469,354,695,116,170,53,216,269,315,70,22,127,121,1370
362,T.J. McConnell,PG,29,IND,27,8,652,100,208,10,33,90,175,19,23,20,70,90,131,29,10,29,53,229
363,Jaden McDaniels,PF,21,MIN,70,31,1803,255,554,80,252,175,302,57,71,76,217,293,79,52,54,75,224,647
364,Jalen McDaniels,SF,24,CHO,55,2,895,123,254,41,108,82,146,53,72,37,133,170,58,26,22,36,93,340
365,Doug McDermott,PF,30,SAS,51,51,1223,215,465,108,256,107,209,40,51,18,97,115,64,13,6,43,79,578
366,JaVale McGee,C,34,PHO,74,17,1172,288,458,2,9,286,449,102,146,163,333,496,42,22,81,98,181,680
367,Cameron McGriff,SF,24,POR,3,0,46,5,14,2,6,3,8,2,2,6,9,15,3,0,1,0,7,14
368,Rodney McGruder,SG,30,DET,51,2,754,98,225,58,146,40,79,19,26,31,80,111,48,21,7,24,58,273
369,Alfonzo McKinnie,SF,29,CHI,17,3,206,24,61,9,27,15,34,2,8,13,20,33,5,2,3,7,26,59
370,JaQuori McLaughlin,PG,24,DAL,4,0,11,0,2,0,1,0,1,0,0,0,0,0,2,0,0,0,1,0
371,Jordan McLaughlin,PG,25,MIN,62,3,902,88,200,27,85,61,115,30,40,22,72,94,180,57,10,38,54,233
372,Ben McLemore,SG,28,POR,64,6,1285,216,539,151,417,65,122,72,88,12,91,103,59,38,10,55,103,655
373,De'Anthony Melton,SG,23,MEM,73,15,1657,281,695,139,372,142,323,90,120,64,264,328,194,104,39,112,128,791
374,Sam Merrill,SG,25,MEM,6,0,58,8,24,7,23,1,1,2,4,1,6,7,4,0,0,2,3,25
375,Chimezie Metu,C,24,SAC,60,20,1279,203,449,57,186,146,263,71,91,34,301,335,60,51,32,61,93,534
376,Khris Middleton,SF,30,MIL,66,66,2141,452,1021,162,434,290,587,259,291,41,315,356,358,76,18,190,160,1325
377,C.J. Miles,SG,34,BOS,1,0,2,0,0,0,0,0,0,0,0,0,0,0,0,0,0,0,1,0
378,Patty Mills,SG,33,BRK,81,48,2346,324,794,227,568,97,226,48,59,18,138,156,183,51,17,73,112,923
379,Paul Millsap,C,36,TOT,33,1,375,45,115,8,35,37,80,17,24,41,73,114,29,10,13,19,67,115
380,Shake Milton,SG,25,PHI,55,6,1179,173,403,43,133,130,270,61,73,30,112,142,139,28,17,44,99,450
381,Davion Mitchell,PG,23,SAC,75,19,2076,352,843,101,320,251,523,56,85,33,133,166,313,55,24,114,141,861
382,Donovan Mitchell,SG,25,UTA,67,67,2266,617,1376,232,654,385,722,267,313,55,227,282,358,99,12,200,164,1733
383,Evan Mobley,PF,20,CLE,69,69,2331,422,830,23,92,399,738,167,252,143,427,570,174,56,115,133,147,1034
384,Malik Monk,SG,23,LAL,76,37,2139,391,826,173,442,218,384,93,117,37,219,256,218,61,29,122,138,1048
385,Greg Monroe,C,31,TOT,14,0,195,32,57,0,0,32,57,12,23,30,34,64,22,8,10,12,24,76
386,Moses Moody,SG,19,GSW,52,11,607,80,183,40,110,40,73,28,36,17,63,80,23,7,10,13,43,228
387,Xavier Moon,SG,27,LAC,10,0,137,25,51,5,14,20,37,3,5,2,12,14,24,7,3,6,9,58
388,Matt Mooney,SG,25,NYK,1,0,2,0,1,0,1,0,0,0,0,0,0,0,0,1,0,1,0,0
389,Ja Morant,PG,22,MEM,57,57,1889,580,1177,88,256,492,921,316,415,77,248,325,384,66,22,196,86,1564
390,Juwan Morgan,PF,24,TOT,2,0,31,2,3,1,2,1,1,0,0,2,2,4,1,0,0,0,3,5
391,Jaylen Morris,SG,26,SAS,3,0,16,0,6,0,2,0,4,2,4,0,2,2,2,0,0,1,2,2
392,Marcus Morris,PF,32,LAC,54,54,1564,300,691,101,275,199,416,129,148,26,213,239,113,28,18,69,115,830
393,Markieff Morris,PF,32,MIA,17,1,298,54,114,13,39,41,75,8,9,17,28,45,23,6,1,20,33,129
394,Monte Morris,PG,26,DEN,75,74,2239,374,773,124,314,250,459,73,84,27,199,226,333,56,14,78,92,945
395,Emmanuel Mudiay,PG,25,SAC,2,0,11,0,2,0,0,0,2,3,4,0,0,0,4,1,0,1,1,3
396,Mychal Mulder,PG,27,TOT,17,3,240,24,77,17,54,7,23,4,4,2,22,24,5,4,2,8,13,69
397,Ade Murkey,SG,24,SAC,1,0,1,0,0,0,0,0,0,0,0,0,0,0,0,0,0,0,0,0
398,Trey Murphy III,SF,21,NOP,62,1,864,109,277,71,186,38,91,45,51,47,100,147,38,23,7,16,60,334
399,Dejounte Murray,PG,25,SAS,68,68,2366,573,1241,96,294,477,947,196,247,80,483,563,627,138,23,180,138,1438
400,Mike Muscala,C,30,OKC,43,0,592,113,248,70,163,43,85,48,57,21,108,129,22,18,26,14,58,344
401,Svi Mykhailiuk,SF,24,TOR,56,5,716,91,234,41,134,50,100,32,37,20,72,92,45,26,4,32,54,255
402,Abdel Nader,SF,28,PHO,14,0,145,12,35,4,14,8,21,6,10,4,23,27,7,8,4,11,20,34
403,Larry Nance Jr.,C-PF,29,TOT,46,11,1040,129,247,23,70,106,177,40,57,72,176,248,81,43,20,37,84,321
404,RJ Nembhard Jr.,SG,22,CLE,14,0,63,6,18,0,2,6,16,3,4,3,4,7,12,1,0,3,2,15
405,Aaron Nesmith,SF,22,BOS,52,3,574,72,182,31,115,41,67,21,26,15,74,89,22,20,5,31,70,196
406,Raul Neto,PG,29,WAS,70,19,1372,204,441,35,120,169,321,83,108,13,121,134,217,55,3,79,104,526
407,Malik Newman,PG,24,CLE,1,0,8,3,5,0,1,3,4,2,2,0,1,1,1,0,0,1,0,8
408,Georges Niang,PF,28,PHI,76,7,1736,246,563,156,387,90,176,52,59,25,178,203,102,30,13,59,190,700
409,Daishen Nix,SG,19,HOU,24,0,261,27,67,7,26,20,41,16,30,7,26,33,40,15,0,26,21,77
410,Zeke Nnaji,PF,21,DEN,41,1,698,96,186,37,80,59,106,41,65,56,91,147,17,16,13,23,79,270
411,Nerlens Noel,C,27,NYK,25,11,562,32,60,0,3,32,57,21,30,48,93,141,23,30,31,20,67,85
412,Jaylen Nowell,SG,22,MIN,62,1,975,196,413,63,160,133,253,72,92,22,101,123,130,27,10,36,73,527
413,Frank Ntilikina,SG,23,DAL,58,5,685,89,223,38,111,51,112,24,25,12,67,79,69,27,7,31,61,240
414,Jusuf Nurkić,C,27,POR,56,56,1579,321,600,15,56,306,544,185,268,167,452,619,157,62,34,143,189,842
415,David Nwaba,SF,29,HOU,46,4,609,85,176,15,49,70,127,48,67,41,110,151,35,28,20,21,55,233
416,Jordan Nwora,SF,23,MIL,62,13,1185,186,462,79,227,107,235,36,43,37,184,221,59,25,17,57,78,487
417,Royce O'Neale,SF,28,UTA,77,77,2406,203,444,119,306,84,138,45,56,64,304,368,191,86,32,79,183,570
418,Semi Ojeleye,PF,27,TOT,30,0,406,30,99,15,50,15,49,23,29,27,47,74,9,7,6,9,30,98
419,Chuma Okeke,PF,23,ORL,70,20,1749,216,575,118,371,98,204,55,65,47,300,347,118,97,42,57,95,605
420,Josh Okogie,SG,23,MIN,49,6,516,42,104,14,47,28,57,35,51,29,41,70,25,26,12,23,53,133
421,Onyeka Okongwu,C,21,ATL,48,6,992,156,226,0,0,156,226,80,110,115,168,283,53,31,60,44,149,392
422,Isaac Okoro,SF,21,CLE,67,61,1981,207,431,55,157,152,274,119,155,72,129,201,121,56,22,58,164,588
423,KZ Okpala,PF,22,MIA,21,0,244,30,69,9,26,21,43,8,11,11,30,41,14,4,7,5,25,77
424,Victor Oladipo,SG,29,MIA,8,1,173,35,73,15,36,20,37,14,19,3,20,23,28,5,1,16,13,99
425,Cameron Oliver,SF,25,ATL,2,0,43,10,15,1,3,9,12,2,3,2,4,6,3,1,1,0,5,23
426,Kelly Olynyk,C,30,DET,40,1,764,128,286,40,119,88,167,69,89,54,123,177,111,31,19,58,100,365
427,Eugene Omoruyi,SF,24,DAL,4,0,18,2,5,1,2,1,3,2,4,2,5,7,2,0,0,0,2,7
428,Miye Oni,SG,24,UTA,16,0,44,2,9,1,8,1,1,0,1,1,6,7,5,0,0,1,7,5
429,Cedi Osman,SF,26,CLE,66,3,1462,247,572,128,359,119,213,87,131,25,121,146,135,52,10,67,127,709
430,Daniel Oturu,C,22,TOR,3,0,27,3,6,0,1,3,5,3,5,1,4,5,0,0,2,0,1,9
431,Kelly Oubre Jr.,SF,26,CHO,76,13,1999,410,932,191,553,219,379,126,189,79,223,302,84,77,31,67,189,1137
432,Jaysean Paige,PG,27,DET,1,0,7,0,3,0,2,0,1,0,0,0,1,1,1,0,0,1,2,0
433,Trayvon Palmer,SG,27,DET,1,0,17,0,1,0,0,0,1,0,0,0,2,2,0,0,0,1,2,0
434,Kevin Pangos,PG,29,CLE,24,3,166,15,46,6,26,9,20,3,4,2,9,11,30,3,0,7,11,39
435,Jabari Parker,PF,26,BOS,12,0,112,18,38,8,16,10,22,9,9,5,23,28,6,4,1,8,13,53
436,Eric Paschall,PF,25,UTA,58,3,737,114,235,40,108,74,127,66,86,30,76,106,36,9,5,27,51,334
437,Chris Paul,PG,36,PHO,65,65,2139,363,736,63,199,300,537,169,202,22,261,283,702,121,20,153,134,958
438,Cameron Payne,PG,27,PHO,58,12,1278,240,587,71,211,169,376,75,89,24,151,175,282,40,17,103,119,626
439,Elfrid Payton,PG,27,PHO,50,1,549,67,175,4,18,63,157,12,32,21,67,88,99,25,6,47,38,150
440,Gary Payton II,SG,29,GSW,71,16,1248,212,344,43,120,169,224,35,58,72,175,247,64,96,22,40,131,502
441,Norvel Pelle,C,28,UTA,3,0,19,3,5,0,0,3,5,0,0,3,3,6,0,0,1,2,1,6
442,Reggie Perry,PF,21,TOT,10,1,187,40,79,3,16,37,63,9,15,15,32,47,12,9,6,11,33,92
443,Jamorko Pickett,PF,24,DET,13,0,176,18,50,13,39,5,11,1,2,6,26,32,7,0,7,5,12,50
444,Theo Pinson,SF,26,DAL,19,0,148,14,39,10,30,4,9,10,10,2,19,21,17,5,2,5,12,48
445,Mason Plumlee,C,31,CHO,73,73,1793,205,320,0,2,205,318,67,171,176,389,565,226,61,52,100,224,477
446,Jakob Poeltl,C,26,SAS,68,67,1970,410,663,1,1,409,662,94,190,262,372,634,189,45,118,109,212,915
447,Aleksej Pokusevski,PF,20,OKC,61,12,1233,186,456,57,197,129,259,35,50,73,245,318,131,39,38,94,88,464
448,Yves Pons,SF,22,MEM,12,0,71,5,16,3,9,2,7,0,2,5,7,12,1,1,4,1,6,13
449,Jordan Poole,SG,22,GSW,76,51,2283,474,1058,211,580,263,478,246,266,34,226,260,304,60,23,187,206,1405
450,Kevin Porter Jr.,PG,21,HOU,61,61,1907,335,808,155,413,180,395,124,193,43,224,267,376,69,22,192,156,949
451,Michael Porter Jr.,SF,23,DEN,9,9,265,37,103,10,48,27,55,5,9,9,50,59,17,10,2,12,16,89
452,Otto Porter Jr.,PF,28,GSW,63,15,1396,193,416,80,216,113,200,49,61,86,276,362,94,68,29,37,83,515
453,Bobby Portis,C,26,MIL,72,59,2028,417,871,133,338,284,533,85,113,180,477,657,86,53,51,90,174,1052
454,Kristaps Porziņģis,PF,26,TOT,51,51,1481,352,767,78,252,274,515,248,286,102,309,411,119,37,84,81,137,1030
455,Micah Potter,C,23,DET,3,0,31,5,11,0,2,5,9,2,2,4,5,9,0,1,1,1,4,12
456,Dwight Powell,C,30,DAL,82,71,1798,269,401,13,37,256,364,166,212,173,231,404,97,37,39,64,220,717
457,Myles Powell,PG,24,PHI,11,0,52,5,17,1,6,4,11,2,2,1,5,6,3,1,0,3,8,13
458,Norman Powell,SF-SG,28,TOT,45,41,1458,279,605,106,253,173,352,189,233,20,125,145,96,42,21,69,106,853
459,Joshua Primo,SF,19,SAS,50,16,965,101,270,42,137,59,133,44,59,32,81,113,81,20,23,57,79,288
460,Taurean Prince,PF,27,MIN,69,8,1177,177,390,86,229,91,161,62,82,26,148,174,68,47,23,53,116,502
461,Payton Pritchard,PG,24,BOS,71,2,1001,160,373,101,245,59,128,21,21,32,102,134,139,25,6,41,61,442
462,Trevelin Queen,SG,24,HOU,10,0,74,15,33,9,24,6,9,4,4,7,9,16,4,5,1,7,6,43
463,Neemias Queta,C,22,SAC,15,0,120,17,38,0,0,17,38,11,17,14,17,31,6,1,8,6,18,45
464,Immanuel Quickley,PG,22,NYK,78,3,1802,284,724,137,396,147,328,177,201,31,216,247,275,54,3,99,167,882
465,Jahmi'us Ramsey,SG,20,SAC,19,0,134,24,58,5,18,19,40,7,14,4,9,13,7,1,1,5,10,60
466,Julius Randle,PF,27,NYK,72,72,2544,512,1246,120,390,392,856,303,401,125,591,716,370,53,39,245,205,1447
467,Austin Reaves,SG,23,LAL,61,19,1418,146,318,53,167,93,151,99,118,45,148,193,110,29,20,40,87,444
468,Cam Reddish,SF,22,TOT,49,7,1012,165,408,66,184,99,224,101,112,25,80,105,48,47,15,57,60,497
469,Davon Reed,SG,26,DEN,48,5,668,81,161,37,86,44,75,10,15,14,94,108,53,24,9,16,63,209
470,Paul Reed,C,22,PHI,38,2,302,54,96,2,8,52,88,6,14,44,48,92,16,33,14,10,57,116
471,Naz Reid,C,22,MIN,77,6,1215,233,476,57,166,176,310,114,149,102,199,301,71,40,71,82,172,637
472,Nick Richards,C,24,CHO,50,5,367,60,90,0,0,60,90,30,43,34,52,86,13,9,21,24,51,150
473,Josh Richardson,SG,28,TOT,65,7,1600,234,534,102,246,132,288,96,108,42,143,185,115,56,29,66,116,666
474,Austin Rivers,SG,29,DEN,67,18,1480,146,350,79,231,67,119,32,44,19,95,114,90,51,6,54,121,403
475,Duncan Robinson,SG,27,MIA,79,68,2043,290,726,232,624,58,102,51,61,24,179,203,129,42,14,60,201,863
476,Justin Robinson,PG,24,TOT,25,0,304,28,93,18,61,10,32,4,8,4,17,21,32,9,1,17,27,78
477,Mitchell Robinson,C,23,NYK,72,62,1848,261,343,0,0,261,343,88,181,295,322,617,38,58,133,60,195,610
478,Jeremiah Robinson-Earl,C,21,OKC,49,36,1087,134,324,58,165,76,159,40,54,75,199,274,49,29,15,39,75,366
479,Isaiah Roby,PF,23,OKC,45,28,948,166,323,44,99,122,224,78,116,75,142,217,71,36,34,43,109,454
480,Rajon Rondo,PG,35,TOT,39,1,698,68,176,31,88,37,88,19,26,15,93,108,170,30,6,68,56,186
481,Derrick Rose,PG,33,NYK,26,4,636,122,274,37,92,85,182,30,31,21,57,78,103,22,12,39,15,311
482,Terrence Ross,SG,30,ORL,63,0,1448,220,554,77,264,143,290,112,130,20,141,161,116,28,12,75,68,629
483,Terry Rozier,SG,27,CHO,73,73,2458,518,1167,222,593,296,574,150,176,56,259,315,326,93,25,96,119,1408
484,Ricky Rubio,PG,31,CLE,34,8,970,149,411,59,174,90,237,88,103,15,126,141,225,49,7,90,75,445
485,D'Angelo Russell,PG,25,MIN,65,65,2077,401,975,176,518,225,457,198,240,25,191,216,460,62,22,165,130,1176
486,Matt Ryan,SF,24,BOS,1,0,5,1,5,1,5,0,0,0,0,0,0,0,0,1,0,0,0,3
487,Domantas Sabonis,PF,25,TOT,62,61,2136,443,773,39,125,404,648,246,332,201,551,752,323,59,27,195,203,1171
488,Olivier Sarr,C,22,OKC,22,2,421,58,101,13,29,45,72,24,29,34,59,93,19,6,15,22,52,153
489,Tomáš Satoranský,SG-PG-SF,30,TOT,55,13,906,72,191,11,53,61,138,43,54,27,99,126,184,29,5,46,71,198
490,Jordan Schakel,SG,23,WAS,4,0,30,1,11,1,6,0,5,2,2,2,6,8,0,1,0,1,0,5
491,Admiral Schofield,SF,24,ORL,38,1,469,54,129,26,79,28,50,12,15,17,72,89,25,4,5,21,58,146
492,Dennis Schröder,PG,28,TOT,64,29,1837,312,724,86,250,226,474,157,184,34,180,214,296,53,8,143,154,867
493,Tre Scott,SF,25,CLE,2,0,11,3,6,0,1,3,5,0,0,1,1,2,0,1,1,0,2,6
494,Jay Scrubb,SG,21,LAC,18,0,121,18,46,6,21,12,25,7,10,2,14,16,8,4,3,7,9,49
495,Wayne Selden,SG,27,NYK,3,0,19,1,4,1,2,0,2,2,4,0,1,1,1,0,0,0,1,5
496,Alperen Şengün,C,19,HOU,72,13,1489,249,525,29,117,220,408,165,232,138,255,393,185,59,68,145,214,692
497,Collin Sexton,SG,23,CLE,11,11,316,68,151,11,45,57,106,29,39,13,23,36,23,10,0,31,25,176
498,Landry Shamet,SG,24,PHO,69,14,1437,191,485,123,334,68,151,68,81,16,110,126,108,28,9,41,92,573
499,Day'Ron Sharpe,PF,20,BRK,32,8,391,86,149,2,7,84,142,24,41,81,79,160,17,10,15,30,60,198
500,Pascal Siakam,PF,27,TOR,68,68,2578,596,1207,75,218,521,989,284,379,128,452,580,360,85,42,181,225,1551
501,Chris Silva,PF,25,TOT,10,0,91,8,15,0,0,8,15,10,12,13,23,36,7,0,1,8,20,26
502,Marko Simonovic,C,22,CHI,9,0,35,4,15,1,5,3,10,8,11,5,5,10,0,1,1,2,6,17
503,Anfernee Simons,SG,22,POR,57,30,1681,353,797,179,442,174,355,103,116,26,125,151,221,30,6,115,110,988
504,Zavier Simpson,PG,24,OKC,4,4,174,19,52,1,8,18,44,5,5,2,19,21,30,5,4,10,15,44
505,Jericho Sims,PF,23,NYK,41,5,555,39,54,0,0,39,54,12,29,61,108,169,21,11,22,20,66,90
506,Deividas Sirvydis,SG,21,DET,3,0,27,1,10,1,7,0,3,0,0,0,6,6,1,3,1,0,4,3
507,Javonte Smart,PG,22,TOT,17,1,200,19,60,8,27,11,33,5,6,5,19,24,16,6,3,11,12,51
508,Marcus Smart,PG,27,BOS,71,71,2296,300,718,119,360,181,358,142,179,42,228,270,417,119,18,159,160,861
509,Dennis Smith Jr.,PG,24,POR,37,4,638,79,189,6,27,73,162,42,64,20,68,88,132,45,12,51,52,206
510,Ish Smith,PG,33,TOT,65,1,1126,185,430,25,67,160,363,15,24,25,115,140,244,47,23,78,78,410
511,Jalen Smith,PF,21,TOT,51,8,924,176,350,40,122,136,228,78,102,101,206,307,24,15,41,42,96,470
512,Xavier Sneed,SF,24,TOT,9,0,39,2,10,1,8,1,2,0,0,2,4,6,1,0,0,0,2,5
513,Tony Snell,SG,30,TOT,53,12,822,69,171,45,128,24,43,4,4,16,87,103,28,16,9,19,70,187
514,Jaden Springer,SG,19,PHI,2,0,6,1,1,0,0,1,1,0,0,1,1,2,0,0,2,1,0,2
515,Cassius Stanley,SG,22,DET,9,1,155,19,46,4,17,15,29,10,10,5,14,19,4,5,2,6,17,52
516,Nik Stauskas,SG,28,TOT,8,0,39,5,14,4,10,1,4,4,6,1,2,3,2,0,0,1,1,18
517,Lance Stephenson,PG-SG,31,TOT,46,1,814,147,323,27,90,120,233,63,80,12,115,127,165,24,4,72,96,384
518,Lamar Stevens,PF,24,CLE,63,13,1015,156,319,18,65,138,254,53,75,47,117,164,44,31,18,41,106,383
519,Isaiah Stewart,C,20,DET,71,71,1816,250,490,15,46,235,444,74,103,226,391,617,82,22,78,85,211,589
520,Max Strus,SF,25,MIA,68,16,1587,249,564,181,442,68,122,42,53,24,178,202,92,28,16,57,116,721
521,Jalen Suggs,PG,20,ORL,48,45,1307,198,548,42,196,156,352,126,163,26,145,171,209,59,19,143,142,564
522,Craig Sword,SG,28,WAS,3,0,19,3,4,0,1,3,3,0,0,0,0,0,1,4,0,1,7,6
523,Keifer Sykes,PG,28,IND,32,11,566,69,190,27,90,42,100,15,17,8,37,45,62,12,4,33,51,180
524,Jae'Sean Tate,PF,26,HOU,78,77,2056,363,729,63,202,300,527,130,184,135,285,420,222,72,41,139,286,919
525,Jayson Tatum,SF,23,BOS,76,76,2731,708,1564,230,651,478,913,400,469,85,524,609,334,75,49,217,174,2046
526,Terry Taylor,PF,22,IND,33,7,714,135,220,12,38,123,182,36,51,95,77,172,41,14,8,23,61,318
527,Garrett Temple,SG,35,NOP,59,16,1098,111,295,59,185,52,110,28,41,29,114,143,74,43,23,42,81,309
528,Emanuel Terry,PF,25,PHO,3,0,18,0,5,0,0,0,5,0,0,8,7,15,2,1,0,5,4,0
529,Tyrell Terry,PG,21,MEM,2,0,3,1,1,0,0,1,1,0,0,0,0,0,0,0,0,0,1,2
530,Jon Teske,C,24,MEM,3,0,8,0,1,0,0,0,1,0,2,0,2,2,1,1,0,0,1,0
531,Daniel Theis,C,29,TOT,47,27,977,151,291,33,107,118,184,49,72,59,169,228,41,20,31,46,111,384
532,Brodric Thomas,SG,25,BOS,12,0,60,8,18,2,9,6,9,3,5,2,8,10,11,1,1,6,7,21
533,Cam Thomas,SG,20,BRK,67,2,1176,218,503,47,174,171,329,87,105,16,145,161,78,33,8,55,66,570
534,Isaiah Thomas,PG,32,TOT,22,1,333,67,167,28,83,39,84,22,26,4,25,29,34,7,5,15,34,184
535,Matt Thomas,SG,27,CHI,40,0,459,55,134,35,91,20,43,16,20,3,47,50,20,8,3,8,18,161
536,Klay Thompson,SG,31,GSW,32,32,941,246,573,114,296,132,277,46,51,15,110,125,88,16,17,43,54,652
537,Tristan Thompson,PF,30,TOT,57,6,896,141,267,1,3,140,264,61,116,120,168,288,34,23,21,45,98,344
538,JT Thor,PF,19,CHO,33,0,262,24,55,7,27,17,28,12,20,11,32,43,19,8,11,10,26,67
539,Matisse Thybulle,SG,24,PHI,66,50,1685,150,300,45,144,105,156,34,43,42,109,151,75,115,71,39,158,379
540,Killian Tillie,C,23,MEM,36,3,461,43,127,27,86,16,41,5,8,21,39,60,22,23,15,13,58,118
541,Xavier Tillman Sr.,PF,23,MEM,53,2,701,98,216,10,49,88,167,46,71,66,95,161,62,49,15,34,63,252
542,Isaiah Todd,PF,20,WAS,12,0,74,7,26,4,16,3,10,2,6,3,9,12,4,4,2,4,4,20
543,Obi Toppin,PF,23,NYK,72,10,1230,251,473,52,169,199,304,94,124,69,199,268,77,25,33,56,102,648
544,Juan Toscano-Anderson,SF,28,GSW,73,6,994,115,235,28,87,87,148,40,70,28,148,176,127,48,17,68,115,298
545,Karl-Anthony Towns,C,26,MIN,74,74,2476,642,1214,150,366,492,848,384,467,194,533,727,269,72,83,226,267,1818
546,Gary Trent Jr.,SG,23,TOR,70,69,2448,450,1086,209,545,241,541,174,204,26,165,191,141,122,19,73,144,1283
547,P.J. Tucker,PF,36,MIA,71,70,1981,207,428,80,193,127,235,45,61,100,287,387,149,58,15,66,161,539
548,Rayjon Tucker,SG,24,TOT,5,0,71,6,9,4,5,2,4,5,7,3,5,8,10,4,0,1,5,21
549,Myles Turner,C,25,IND,42,42,1235,200,393,61,183,139,210,79,105,65,232,297,44,28,118,54,119,540
550,Jonas Valančiūnas,C,29,NOP,74,74,2240,510,938,57,158,453,780,237,289,226,617,843,190,41,60,179,247,1314
551,Denzel Valentine,SG,28,TOT,24,0,222,25,66,19,47,6,19,0,0,9,33,42,11,8,0,12,20,69
552,Jarred Vanderbilt,PF,22,MIN,74,67,1880,212,361,2,14,210,347,86,131,215,409,624,94,99,46,73,181,512
553,Fred VanVleet,PG,27,TOR,65,65,2462,442,1097,242,642,200,455,194,222,44,245,289,434,111,35,170,162,1320
554,Devin Vassell,SF,21,SAS,71,32,1937,326,764,137,380,189,384,83,99,44,262,306,136,76,41,58,143,872
555,Gabe Vincent,PG,25,MIA,68,27,1589,214,513,119,323,95,190,44,54,22,104,126,210,62,12,98,158,591
556,Nikola Vučević,C,31,CHI,73,73,2418,546,1154,104,331,442,823,92,121,142,662,804,236,70,71,136,181,1288
557,Dean Wade,PF,25,CLE,51,28,980,99,217,51,142,48,75,20,30,31,119,150,52,29,7,16,88,269
558,Franz Wagner,SF,20,ORL,79,79,2429,456,975,96,271,360,704,189,219,84,272,356,231,68,34,119,164,1197
559,Moritz Wagner,C,24,ORL,63,3,960,197,396,66,201,131,195,104,129,42,190,232,87,20,13,56,123,564
560,Ish Wainright,PF,27,PHO,45,0,359,41,104,19,59,22,45,7,12,27,27,54,15,20,6,13,49,108
561,Kemba Walker,PG,31,NYK,37,37,948,149,370,73,199,76,171,60,71,14,97,111,131,26,7,48,37,431
562,Lonnie Walker IV,SG,23,SAS,70,6,1612,311,764,111,353,200,411,116,148,18,163,181,152,44,19,71,98,849
563,M.J. Walker,SG,23,PHO,2,0,8,0,4,0,2,0,2,0,0,0,1,1,1,2,0,0,1,0
564,Tyrone Wallace,SG,27,NOP,6,0,75,7,20,2,8,5,12,1,5,0,8,8,1,3,1,2,7,17
565,Derrick Walton,PG,26,DET,3,3,108,6,26,3,13,3,13,4,4,2,8,10,21,7,4,11,8,19
566,Brad Wanamaker,PG,32,TOT,23,2,320,28,77,4,17,24,60,23,25,6,33,39,55,7,6,23,45,83
567,Duane Washington Jr.,PG,21,IND,48,7,968,173,427,81,215,92,212,46,61,4,79,83,85,26,3,57,66,473
568,P.J. Washington,C,23,CHO,65,28,1768,250,532,110,301,140,231,58,81,82,255,337,147,57,61,82,152,668
569,Yuta Watanabe,SF,27,TOR,38,4,445,56,138,27,79,29,59,24,40,18,74,92,21,11,16,19,38,163
570,Lindy Waters III,SG,24,OKC,25,1,465,71,175,53,146,18,29,4,5,6,67,73,24,19,8,11,31,199
571,Tremont Waters,PG,24,TOT,3,0,50,4,14,2,9,2,5,0,0,0,4,4,7,5,0,4,4,10
572,Trendon Watford,SF,21,POR,48,10,869,142,267,9,38,133,229,71,94,57,142,199,81,25,28,44,116,364
573,Paul Watson,SF,27,OKC,9,3,156,12,35,6,26,6,9,1,2,3,24,27,8,3,3,4,10,31
574,Quinndary Weatherspoon,SG,25,GSW,11,0,73,12,21,1,5,11,16,5,5,2,12,14,5,1,1,3,15,30
575,Russell Westbrook,PG,33,LAL,78,78,2678,548,1233,79,265,469,968,266,399,110,470,580,550,75,20,295,235,1441
576,Coby White,PG,21,CHI,61,17,1675,279,644,136,353,143,291,78,91,17,165,182,176,29,11,70,137,772
577,Derrick White,SG,27,TOT,75,52,2199,337,800,115,369,222,431,203,235,38,223,261,366,64,58,119,172,992
578,Hassan Whiteside,C,32,UTA,65,8,1162,215,330,0,0,215,330,104,167,166,328,494,26,22,103,53,179,534
579,Joe Wieskamp,SG,22,SAS,29,0,205,20,56,14,43,6,13,7,13,4,10,14,9,4,3,2,14,61
580,Aaron Wiggins,SG,23,OKC,50,35,1209,156,337,42,138,114,199,62,85,51,127,178,68,30,10,54,93,416
581,Andrew Wiggins,SF,26,GSW,73,73,2330,475,1019,157,399,318,620,149,235,85,240,325,161,76,51,111,158,1256
582,Lindell Wigginton,PG,23,MIL,19,0,199,26,61,9,26,17,35,19,35,3,22,25,23,5,1,12,17,80
583,Brandon Williams,PG,22,POR,24,16,640,105,282,31,106,74,176,68,97,19,55,74,94,24,10,58,52,309
584,Grant Williams,PF,23,BOS,77,21,1875,205,432,106,258,99,174,86,95,64,210,274,78,38,57,62,186,602
585,Kenrich Williams,SF,27,OKC,49,0,1072,146,317,41,121,105,196,30,55,75,145,220,108,44,10,46,81,363
586,Lou Williams,PG,35,ATL,56,0,799,125,320,37,102,88,218,67,78,16,71,87,105,28,3,43,48,354
587,Patrick Williams,PF,20,CHI,17,9,422,54,102,15,29,39,73,30,41,17,52,69,15,9,9,16,28,153
588,Robert Williams,C,24,BOS,61,61,1804,271,368,0,1,271,367,65,90,238,350,588,121,56,134,63,137,607
589,Ziaire Williams,SF,20,MEM,62,31,1346,191,424,76,242,115,182,43,55,26,103,129,65,35,12,41,113,501
590,D.J. Wilson,PF,25,TOR,4,1,54,11,15,0,2,11,13,8,10,1,15,16,5,5,1,2,6,30
591,Dylan Windler,SF,25,CLE,50,0,459,37,98,21,70,16,28,15,18,21,68,89,34,14,3,16,47,110
592,Justise Winslow,PF,25,TOT,48,11,775,110,257,15,66,95,191,39,66,50,152,202,84,35,25,49,67,274
593,Cassius Winston,PG,23,WAS,7,0,39,4,11,2,6,2,5,4,4,0,1,1,7,0,0,3,9,14
594,Christian Wood,C,26,HOU,68,67,2094,440,878,131,336,309,542,207,332,110,576,686,155,54,65,126,171,1218
595,Robert Woodard II,SF,22,SAC,12,0,42,2,16,1,4,1,12,2,2,5,6,11,3,1,1,1,3,7
596,Delon Wright,SG,29,ATL,77,8,1452,122,269,44,116,78,153,54,63,50,170,220,188,93,19,45,56,342
597,McKinley Wright IV,PG,23,MIN,5,0,19,2,3,1,2,1,1,0,0,0,0,0,3,0,0,1,1,5
598,Moses Wright,PF,23,TOT,4,0,15,1,4,0,1,1,3,3,3,1,2,3,2,0,1,0,0,5
599,Gabe York,SG,28,IND,2,0,21,2,7,1,6,1,1,3,5,0,2,2,4,2,1,1,4,8
600,Thaddeus Young,PF,33,TOT,52,1,845,141,272,17,48,124,224,23,49,80,128,208,104,54,18,52,81,322
601,Trae Young,PG,23,ATL,76,76,2652,711,1544,233,610,478,934,500,553,50,234,284,737,72,7,303,128,2155
602,Omer Yurtseven,C,23,MIA,56,12,706,130,247,1,11,129,236,38,61,85,209,294,49,17,20,41,84,299
603,Cody Zeller,C,29,POR,27,0,355,51,90,0,4,51,86,38,49,50,75,125,22,8,6,19,56,140
604,Ivica Zubac,C,24,LAC,76,76,1852,310,495,0,0,310,495,165,227,217,427,644,120,36,77,114,203,785
