,Player,Pos,Age,Tm,G,GS,MP,FG,FGA,3P,3PA,2P,2PA,FT,FTA,ORB,DRB,TRB,AST,STL,BLK,TOV,PF,PTS
0,Precious Achiuwa,C,23,TOR,55,12,1140,196,404,29,108,167,296,87,124,100,228,328,50,31,30,59,102,508
1,Steven Adams,C,29,MEM,42,42,1133,157,263,0,1,157,262,47,129,214,271,485,97,36,46,79,98,361
2,Bam Adebayo,C,25,MIA,75,75,2598,602,1114,1,12,601,1102,324,402,184,504,688,240,88,61,187,208,1529
3,Ochai Agbaji,SG,22,UTA,59,22,1209,165,386,81,228,84,158,56,69,43,78,121,67,16,15,41,99,467
4,Santi Aldama,PF,22,MEM,77,20,1682,247,525,94,266,153,259,108,144,85,286,371,97,45,48,60,143,696
5,Nickeil Alexander-Walker,SG,24,TOT,59,3,884,131,295,61,159,70,136,40,60,15,86,101,108,32,21,55,88,363
6,Grayson Allen,SG,27,MIL,72,70,1972,245,557,146,366,99,191,114,126,61,176,237,163,62,14,72,117,750
7,Jarrett Allen,C,24,CLE,68,68,2220,403,626,1,10,402,616,162,221,221,445,666,113,54,84,93,153,969
8,Jose Alvarado,PG,24,NOP,61,10,1310,201,489,83,247,118,242,65,80,28,113,141,186,67,10,81,125,550
9,Kyle Anderson,PF,29,MIN,69,46,1957,252,495,43,105,209,390,100,136,66,302,368,335,78,63,103,146,647
10,Giannis Antetokounmpo,PF,28,MIL,63,63,2024,707,1278,47,171,660,1107,498,772,137,605,742,359,52,51,246,197,1959
11,Thanasis Antetokounmpo,PF,30,MIL,37,0,206,20,46,0,8,20,38,11,22,15,29,44,15,3,3,12,22,51
12,Cole Anthony,PG,22,ORL,60,4,1552,277,610,75,206,202,404,152,170,47,241,288,235,37,31,91,158,781
13,OG Anunoby,SF,25,TOR,67,67,2386,421,885,142,367,279,518,140,167,95,237,332,131,128,50,132,200,1124
14,Ryan Arcidiacono,PG,28,TOT,20,4,172,9,37,8,23,1,14,0,0,0,15,15,23,5,0,7,17,26
15,Deni Avdija,SF,22,WAS,76,40,2020,253,579,69,232,184,347,122,165,74,413,487,211,65,29,123,209,697
16,Deandre Ayton,C,24,PHO,67,67,2035,522,887,7,24,515,863,152,200,172,495,667,115,37,53,120,190,1203
17,Udoka Azubuike,C,23,UTA,36,4,359,59,72,0,0,59,72,7,20,31,88,119,11,6,15,18,34,125
18,Marvin Bagley III,C,23,DET,42,25,990,202,382,19,66,183,316,81,108,94,175,269,36,19,30,46,81,504
19,Patrick Baldwin Jr.,SF,20,GSW,31,0,226,43,109,32,84,11,25,4,6,1,39,40,11,6,4,11,14,122
20,LaMelo Ball,PG,21,CHO,36,36,1268,296,721,144,383,152,338,102,122,42,189,231,304,46,11,129,118,838
21,Mo Bamba,C,24,TOT,49,7,769,117,241,48,124,69,117,41,62,58,167,225,46,13,43,30,105,323
22,Paolo Banchero,PF,20,ORL,72,72,2430,479,1122,85,285,394,837,394,534,84,413,497,269,60,39,200,160,1437
23,Desmond Bane,SG,24,MEM,58,58,1841,450,939,166,407,284,532,181,205,43,248,291,254,56,22,126,150,1247
24,Dalano Banton,PG,23,TOR,31,2,279,55,130,15,51,40,79,17,24,11,34,45,36,13,13,18,34,142
25,Dominick Barlow,PF,19,SAS,28,0,408,46,86,0,4,46,82,18,25,46,56,102,24,10,19,15,56,110
26,Harrison Barnes,PF,30,SAC,82,82,2662,374,791,132,353,242,438,350,413,87,279,366,128,57,10,86,103,1230
27,Scottie Barnes,SF,21,TOR,77,76,2678,463,1016,63,224,400,792,190,246,179,333,512,371,83,61,154,170,1179
28,RJ Barrett,SG,22,NYK,73,73,2475,510,1176,121,390,389,786,290,392,60,308,368,201,31,15,164,179,1431
29,Will Barton,SG,32,TOT,56,2,993,138,364,66,180,72,184,37,47,15,122,137,112,28,13,48,56,379
30,Charles Bassey,C,22,SAS,35,2,508,87,135,3,8,84,127,22,37,75,118,193,47,16,33,41,74,199
31,Keita Bates-Diop,PF,27,SAS,67,42,1452,236,465,56,142,180,323,119,150,65,183,248,103,46,20,56,63,647
32,Nicolas Batum,PF,34,LAC,78,19,1709,160,381,124,317,36,64,34,48,62,237,299,121,54,44,50,149,478
33,Darius Bazley,C,22,TOT,43,1,616,83,183,20,53,63,130,38,70,34,104,138,38,22,34,27,44,224
34,Bradley Beal,SG,29,WAS,50,50,1673,444,878,80,219,364,659,192,228,41,155,196,271,45,33,145,107,1160
35,Malik Beasley,SG,26,TOT,81,27,2093,370,937,235,658,135,279,50,65,35,248,283,124,65,9,90,107,1025
36,MarJon Beauchamp,SF,22,MIL,52,11,701,96,243,47,142,49,101,27,37,38,77,115,35,21,7,45,71,266
37,Dāvis Bertāns,PF,30,DAL,45,1,492,69,160,55,141,14,19,13,15,10,43,53,21,11,8,10,53,206
38,Patrick Beverley,SG-PG,34,TOT,67,67,1816,144,360,80,239,64,121,47,65,44,203,247,194,63,41,60,187,415
39,Saddiq Bey,SF,23,TOT,77,37,2129,353,836,151,418,202,418,205,238,98,264,362,118,70,13,71,123,1062
40,Khem Birch,C,30,TOR,20,0,162,19,32,1,2,18,30,4,5,8,17,25,7,5,5,8,24,43
41,Goga Bitadze,C,23,TOT,38,1,457,69,125,6,26,63,99,23,42,61,76,137,39,16,26,22,64,167
42,Bismack Biyombo,C,30,PHO,61,14,874,119,206,0,0,119,206,25,70,89,171,260,56,18,88,51,114,263
43,Buddy Boeheim,SF,23,DET,10,0,90,5,27,4,25,1,2,2,2,2,4,6,4,2,0,0,6,16
44,Bogdan Bogdanović,SG,30,ATL,54,9,1508,273,611,146,360,127,251,64,77,23,142,165,150,43,18,65,86,756
45,Bojan Bogdanović,PF,33,DET,59,59,1893,430,882,145,353,285,529,268,303,36,187,223,152,34,8,135,113,1273
46,Bol Bol,PF,23,ORL,70,33,1505,261,478,30,113,231,365,82,108,69,336,405,69,30,85,112,92,634
47,Leandro Bolmaro,SF,22,UTA,14,0,68,3,20,0,4,3,16,0,0,4,3,7,7,3,1,7,10,6
48,Devin Booker,SG,26,PHO,53,53,1835,527,1067,111,316,416,751,306,358,46,194,240,293,51,18,145,159,1471
49,Brandon Boston Jr.,SF,21,LAC,22,1,248,51,122,12,29,39,93,29,38,7,23,30,20,9,0,12,21,143
50,Chris Boucher,PF,30,TOR,76,0,1523,261,529,62,189,199,340,128,168,157,264,421,29,47,64,41,143,712
51,James Bouknight,SG,22,CHO,34,0,515,69,193,33,109,36,84,20,30,8,64,72,41,14,5,32,49,191
52,Jamaree Bouyea,PG,23,TOT,5,0,71,6,14,2,6,4,8,1,2,1,5,6,4,4,2,4,6,15
53,Tony Bradley,C,25,CHI,12,0,33,6,12,3,5,3,7,4,4,1,10,11,1,1,1,1,2,19
54,Malaki Branham,SG,19,SAS,66,32,1550,269,611,77,255,192,356,58,70,28,153,181,127,33,7,76,115,673
55,Jarrell Brantley,PF,26,UTA,4,0,39,8,14,4,9,4,5,2,2,1,5,6,3,0,2,2,3,22
56,Christian Braun,SG,21,DEN,76,6,1181,143,289,34,96,109,193,40,64,48,133,181,59,41,17,35,101,360
57,Mikal Bridges,SF-SG,26,TOT,83,83,2963,593,1267,169,442,424,825,316,353,79,285,364,273,91,61,127,159,1671
58,Oshae Brissett,PF,24,IND,65,2,1083,123,319,48,155,75,164,104,145,62,156,218,44,33,13,34,79,398
59,Malcolm Brogdon,PG,30,BOS,67,0,1744,354,732,132,297,222,435,160,184,42,238,280,248,45,18,98,109,1000
60,Dillon Brooks,SF,27,MEM,73,73,2214,392,991,143,439,249,552,120,154,45,199,244,189,65,16,104,240,1047
61,Bruce Brown,SF,26,DEN,80,31,2280,358,741,91,254,267,487,116,153,63,265,328,268,87,51,123,190,923
62,Greg Brown III,PF,21,POR,16,0,93,11,28,1,7,10,21,5,12,2,17,19,3,4,5,6,13,28
63,Jaylen Brown,SF,26,BOS,67,67,2405,679,1383,163,487,516,896,263,344,78,381,459,232,75,26,197,172,1784
64,Kendall Brown,SG,19,IND,6,0,40,4,7,0,1,4,6,1,2,2,4,6,3,4,0,2,9,9
65,Moses Brown,C,23,TOT,36,1,294,61,96,0,0,61,96,33,72,57,82,139,4,4,14,15,39,155
66,Sterling Brown,SF,27,LAL,4,0,24,0,4,0,2,0,2,0,0,3,5,8,2,3,0,0,4,0
67,Troy Brown Jr.,SF,23,LAL,76,45,1860,200,465,107,281,93,184,34,39,62,246,308,95,59,16,49,120,541
68,Jalen Brunson,PG,26,NYK,68,68,2379,587,1195,134,322,453,873,325,392,40,201,241,421,61,15,142,152,1633
69,Thomas Bryant,C,25,TOT,59,26,1081,230,369,26,59,204,310,93,126,86,253,339,31,16,30,38,102,579
70,Reggie Bullock,SF,31,DAL,78,55,2364,192,470,151,397,41,73,26,37,32,251,283,108,54,13,36,166,561
71,Alec Burks,SG,31,DET,51,8,1122,200,459,99,239,101,220,153,188,19,139,158,114,38,8,58,98,652
72,Deonte Burton,PF,29,SAC,2,0,6,0,2,0,1,0,1,0,0,0,0,0,0,0,0,0,0,0
73,Jared Butler,PG,22,OKC,6,1,77,15,32,7,14,8,18,0,0,1,3,4,8,5,0,5,5,37
74,Jimmy Butler,PF,33,MIA,64,64,2138,479,888,36,103,443,785,472,555,141,234,375,340,117,21,101,80,1466
75,John Butler,C,20,POR,19,1,221,17,53,8,35,9,18,3,4,3,14,17,11,7,9,1,22,45
76,Jamal Cain,PF,23,MIA,18,0,240,37,66,7,20,30,46,17,22,15,37,52,12,11,1,6,21,98
77,Kentavious Caldwell-Pope,SG,29,DEN,76,76,2381,292,632,135,319,157,313,103,125,35,173,208,183,112,35,86,145,822
78,Facundo Campazzo,PG,31,DAL,8,0,52,3,13,3,11,0,2,1,2,0,2,2,9,6,0,3,3,10
79,Vlatko Čančar,PF,25,DEN,60,9,889,108,227,43,115,65,112,38,41,24,104,128,80,22,14,37,84,297
80,Clint Capela,C,28,ATL,65,63,1730,350,536,0,1,350,535,79,131,258,459,717,58,45,79,54,139,779
81,Vernon Carey Jr.,C,21,WAS,11,0,28,2,8,0,0,2,8,2,2,3,8,11,3,2,2,2,5,6
82,Jevon Carter,PG,27,MIL,81,39,1810,239,565,142,337,97,228,31,38,35,167,202,197,66,29,78,158,651
83,Wendell Carter Jr.,C,23,ORL,57,54,1690,322,613,80,225,242,388,144,195,120,377,497,132,30,33,106,159,868
84,Michael Carter-Williams,PG,31,ORL,4,0,44,6,14,1,3,5,11,4,7,1,4,5,7,1,1,4,5,17
85,Alex Caruso,PG,28,CHI,67,36,1575,130,286,55,151,75,135,59,73,42,154,196,193,98,46,77,159,374
86,Julian Champagnie,SF,21,TOT,17,3,320,59,130,33,82,26,48,14,17,10,50,60,10,6,5,11,26,165
87,Justin Champagnie,SF,21,TOT,5,0,34,5,15,1,5,4,10,0,0,3,5,8,4,1,0,0,2,11
88,Kennedy Chandler,PG,20,MEM,36,0,281,35,83,2,15,33,68,6,13,9,29,38,58,12,5,18,15,78
89,Max Christie,SG,19,LAL,41,3,512,44,106,26,62,18,44,14,16,7,68,75,21,9,7,13,33,128
90,Josh Christopher,SG,21,HOU,64,2,786,153,329,21,89,132,240,45,60,20,51,71,73,33,15,60,59,372
91,Brandon Clarke,PF,26,MEM,56,8,1090,229,349,1,6,228,343,99,137,92,218,310,72,34,37,55,131,558
92,Jordan Clarkson,SG,30,UTA,61,61,1988,458,1031,155,459,303,572,200,245,72,174,246,270,33,13,186,120,1271
93,Nic Claxton,C,23,BRK,76,76,2271,414,587,0,2,414,585,133,246,184,518,702,144,65,189,96,212,961
94,Amir Coffey,SF,25,LAC,50,9,625,56,145,11,40,45,105,49,63,17,36,53,53,7,5,21,50,172
95,John Collins,PF,25,ATL,71,71,2130,359,707,70,240,289,467,143,178,77,385,462,85,42,73,79,220,931
96,Zach Collins,C,25,SAS,63,26,1441,284,548,55,147,229,401,108,142,116,286,402,180,37,49,129,199,731
97,Chance Comanche,C,26,POR,1,0,21,3,5,0,0,3,5,1,4,2,1,3,0,0,1,0,0,7
98,Mike Conley,PG,35,TOT,67,66,2029,261,610,135,351,126,259,141,169,33,149,182,450,73,14,103,139,798
99,Pat Connaughton,SF,30,MIL,61,33,1443,165,421,109,322,56,99,27,41,50,233,283,77,37,11,33,69,466
100,Xavier Cooks,PF,27,WAS,10,1,126,17,28,0,1,17,27,4,10,16,22,38,6,6,4,8,13,38
101,Robert Covington,PF,32,LAC,48,0,779,102,229,54,136,48,93,30,40,31,135,166,57,38,33,32,86,288
102,Torrey Craig,PF,32,PHO,79,60,1948,228,500,100,253,128,247,32,45,145,281,426,117,50,62,73,179,588
103,Jae Crowder,PF,32,MIL,18,3,340,45,94,24,55,21,39,10,12,17,52,69,27,12,6,7,27,124
104,Jarrett Culver,SF,23,ATL,10,1,137,17,43,1,12,16,31,9,13,10,28,38,6,6,2,7,14,44
105,Cade Cunningham,PG,21,DET,12,12,400,93,224,17,61,76,163,36,43,12,62,74,72,10,7,39,34,239
106,Seth Curry,SG,32,BRK,61,7,1211,208,449,94,232,114,217,51,55,13,87,100,99,36,7,51,96,561
107,Stephen Curry,PG,34,GSW,56,56,1941,559,1133,273,639,286,494,257,281,39,302,341,352,52,20,179,117,1648
108,Dyson Daniels,PG,19,NOP,59,11,1042,87,208,27,86,60,122,26,40,36,152,188,134,43,11,57,99,227
109,Anthony Davis,C,29,LAL,56,54,1904,542,962,19,74,523,888,348,444,195,507,702,148,59,114,122,146,1451
110,Johnny Davis,SG,20,WAS,28,5,423,66,171,17,70,49,101,14,27,10,55,65,28,10,8,17,48,163
111,Terence Davis,SG,25,SAC,64,5,841,154,364,89,243,65,121,34,43,20,119,139,67,43,12,53,104,431
112,JD Davison,SG,20,BOS,12,0,66,8,19,2,7,6,12,1,2,2,7,9,11,2,2,4,5,19
113,Darius Days,SF,23,HOU,4,0,25,5,12,3,10,2,2,2,2,1,5,6,1,0,1,0,2,15
114,Dewayne Dedmon,C,33,TOT,38,1,426,77,151,12,39,65,112,33,49,34,100,134,26,9,19,25,75,199
115,Matthew Dellavedova,PG,32,SAC,32,0,213,17,50,9,27,8,23,4,7,1,12,13,41,7,0,10,20,47
116,DeMar DeRozan,SF,33,CHI,74,74,2682,657,1303,46,142,611,1161,456,523,34,309,343,377,83,36,153,186,1816
117,Moussa Diabaté,C,21,LAC,22,1,195,24,47,1,2,23,45,10,16,31,19,50,4,7,8,9,15,59
118,Mamadi Diakite,C,26,CLE,22,2,176,24,50,7,21,17,29,2,2,8,22,30,8,4,9,12,26,57
119,Hamidou Diallo,SF,24,DET,56,0,996,215,375,5,21,210,354,87,148,57,137,194,55,53,16,71,124,522
120,Gorgui Dieng,C,33,SAS,31,1,358,45,117,21,75,24,42,10,13,27,80,107,53,4,14,32,57,121
121,Ousmane Dieng,PF,19,OKC,39,1,569,76,181,26,98,50,83,15,23,19,86,105,46,14,7,26,42,193
122,Spencer Dinwiddie,SG-PG,29,TOT,79,79,2725,460,1050,181,490,279,560,268,330,28,242,270,515,67,24,145,187,1369
123,Donte DiVincenzo,SG,26,GSW,72,36,1894,235,540,150,378,85,162,58,71,80,245,325,252,97,10,112,133,678
124,Luka Dončić,PG,23,DAL,66,66,2391,719,1449,185,541,534,908,515,694,54,515,569,529,90,33,236,166,2138
125,Tyler Dorsey,SF,26,DAL,3,0,8,4,5,1,2,3,3,0,0,1,1,2,0,0,0,0,0,9
126,Luguentz Dort,SF,23,OKC,74,73,2272,339,873,135,409,204,464,200,259,128,216,344,154,75,23,92,243,1013
127,Ayo Dosunmu,SG,23,CHI,80,51,2098,281,570,59,189,222,381,66,82,45,175,220,206,62,26,99,182,687
128,Devon Dotson,PG,23,WAS,6,0,53,1,10,1,4,0,6,0,0,6,4,10,8,5,0,3,9,3
129,Jeff Dowtin,PG,25,TOR,25,0,259,25,57,5,16,20,41,6,9,6,17,23,31,9,3,5,13,61
130,PJ Dozier,SF,26,SAC,16,0,79,10,33,2,16,8,17,0,0,1,13,14,10,6,1,5,7,22
131,Goran Dragić,PG,36,TOT,58,0,870,141,335,52,145,89,190,31,45,16,65,81,151,13,4,63,65,365
132,Andre Drummond,C,29,CHI,67,0,849,166,274,0,3,166,271,67,125,138,306,444,33,45,27,75,117,399
133,Chris Duarte,SF,25,IND,46,12,897,123,333,55,174,68,159,61,72,19,96,115,64,25,9,41,65,362
134,David Duke Jr.,SG,23,BRK,23,0,228,36,78,1,12,35,66,12,17,11,18,29,21,10,1,18,31,85
135,Kris Dunn,PG,28,UTA,22,3,568,116,216,17,36,99,180,41,53,9,91,100,124,25,10,35,58,290
136,Kevin Durant,PF,34,TOT,47,47,1672,483,862,93,230,390,632,307,334,17,296,313,235,34,67,156,99,1366
137,Jalen Duren,C,19,DET,67,31,1670,258,398,0,2,258,396,96,157,229,366,595,75,44,59,92,182,612
138,Tari Eason,PF,21,HOU,82,5,1767,296,660,59,172,237,488,109,145,195,301,496,88,96,47,101,189,760
139,Anthony Edwards,SG,21,MIN,79,79,2842,707,1541,213,578,494,963,319,422,47,411,458,350,125,58,259,186,1946
140,Kessler Edwards,SF,22,TOT,36,4,385,36,93,17,55,19,38,11,15,23,38,61,23,14,6,13,40,100
141,Keon Ellis,SG,23,SAC,16,0,71,7,16,6,12,1,4,4,7,4,4,8,6,5,1,1,10,24
142,Joel Embiid,C,28,PHI,66,66,2284,728,1328,66,200,662,1128,661,771,113,557,670,274,66,112,226,205,2183
143,Drew Eubanks,C,25,POR,78,28,1584,214,334,7,18,207,316,83,125,132,286,418,103,40,102,67,169,518
144,Bruno Fernando,C,24,TOT,39,4,405,59,112,0,4,59,108,35,50,54,83,137,31,6,34,25,74,153
145,Dorian Finney-Smith,PF,29,TOT,66,66,2009,196,501,114,338,82,163,45,59,114,202,316,100,55,36,62,144,551
146,Malachi Flynn,PG,24,TOR,53,2,691,87,242,47,133,40,109,25,33,15,61,76,70,21,4,25,65,246
147,Simone Fontecchio,SF,27,UTA,52,6,766,115,312,63,191,52,121,35,44,31,55,86,42,15,8,39,62,328
148,Bryn Forbes,SG,29,MIN,25,0,268,30,83,14,46,16,37,15,15,4,11,15,17,7,2,12,22,89
149,Trent Forrest,SG,24,ATL,23,3,277,25,60,0,2,25,58,2,3,5,32,37,38,7,2,15,17,52
150,Michael Foster Jr.,PF,20,PHI,1,0,1,0,0,0,0,0,0,0,0,0,0,0,0,0,0,0,0,0
151,Evan Fournier,SG,30,NYK,27,7,459,56,166,35,114,21,52,18,21,4,45,49,36,16,3,22,46,165
152,De'Aaron Fox,PG,25,SAC,73,73,2435,682,1331,119,367,563,964,343,440,40,266,306,447,83,23,181,172,1826
153,Markelle Fultz,PG,24,ORL,60,60,1778,349,679,27,87,322,592,112,143,69,165,234,341,87,26,139,131,837
154,Wenyen Gabriel,C,25,LAL,68,2,1024,155,260,10,36,145,224,52,84,116,170,286,36,26,35,46,144,372
155,Daniel Gafford,C,24,WAS,78,47,1604,289,395,0,0,289,395,127,187,163,270,433,84,33,99,85,187,705
156,Darius Garland,PG,23,CLE,69,69,2447,522,1129,169,412,353,717,277,321,28,157,185,538,85,9,199,148,1490
157,Usman Garuba,C,20,HOU,75,1,970,86,177,24,59,62,118,29,47,120,187,307,64,44,29,47,135,225
158,Luka Garza,C,24,MIN,28,0,243,63,116,14,39,49,77,41,52,33,30,63,18,3,2,14,43,181
159,Rudy Gay,PF,36,UTA,56,0,816,109,287,33,130,76,157,42,49,33,130,163,57,19,18,37,68,293
160,Paul George,SF,32,LAC,56,56,1939,459,1004,158,426,301,578,256,294,45,297,342,288,83,20,176,159,1332
161,Taj Gibson,C,37,WAS,49,2,480,65,125,8,24,57,101,30,42,32,61,93,34,15,12,26,84,168
162,Josh Giddey,PF,20,OKC,76,76,2367,539,1118,76,234,463,884,106,145,148,451,599,469,57,31,211,143,1260
163,Shai Gilgeous-Alexander,PG,24,OKC,68,68,2416,704,1381,58,168,646,1213,669,739,59,270,329,371,112,65,192,192,2135
164,Anthony Gill,PF,30,WAS,59,8,624,71,132,4,29,67,103,49,67,37,62,99,34,7,12,15,70,195
165,Jacob Gilyard,PG,24,MEM,1,0,41,1,3,1,3,0,0,0,0,0,4,4,7,3,0,2,3,3
166,Rudy Gobert,C,30,MIN,70,70,2148,360,546,0,3,360,543,219,340,231,583,814,87,56,95,122,210,939
167,Jordan Goodwin,PG,24,WAS,62,7,1106,158,353,38,118,120,235,53,69,57,148,205,168,58,26,57,95,407
168,Aaron Gordon,PF,27,DEN,68,68,2055,429,761,60,173,369,588,191,314,164,282,446,203,54,51,98,129,1109
169,Eric Gordon,SG,34,TOT,69,58,1965,291,653,132,356,159,297,142,173,16,118,134,183,43,25,104,78,856
170,Devonte' Graham,PG,27,TOT,73,8,1338,161,431,119,338,42,93,98,131,19,103,122,196,45,16,53,79,539
171,Jerami Grant,PF,28,POR,63,63,2246,434,913,144,359,290,554,278,342,53,230,283,150,51,53,116,152,1290
172,RaiQuan Gray,PF,23,BRK,1,0,35,6,12,2,5,4,7,2,2,3,6,9,7,0,1,4,5,16
173,A.J. Green,SG,23,MIL,35,1,345,53,125,44,105,9,20,4,4,6,39,45,22,6,0,9,31,154
174,Danny Green,SG,35,TOT,11,0,138,22,49,16,37,6,12,1,1,3,11,14,6,6,3,10,16,61
175,Draymond Green,PF,32,GSW,73,73,2297,250,474,40,131,210,343,77,108,66,459,525,500,74,60,204,229,617
176,Jalen Green,SG,20,HOU,76,76,2602,566,1359,187,554,379,805,364,463,43,241,284,281,59,18,200,131,1683
177,JaMychal Green,PF,32,GSW,57,1,797,136,252,42,111,94,141,52,67,72,133,205,51,25,23,52,105,366
178,Javonte Green,SF,29,CHI,32,1,480,61,108,13,35,48,73,30,45,27,61,88,23,24,21,20,52,165
179,Jeff Green,PF,36,DEN,56,4,1091,160,328,30,104,130,224,87,117,38,106,144,69,18,17,46,99,437
180,Josh Green,SG,22,DAL,60,21,1539,205,382,68,169,137,213,68,94,55,127,182,103,42,5,72,156,546
181,AJ Griffin,SF,19,ATL,72,12,1401,248,533,101,259,147,274,42,47,37,116,153,73,42,12,42,87,639
182,Blake Griffin,C,33,BOS,41,16,569,63,130,23,66,40,64,21,32,47,108,155,61,14,9,22,75,170
183,Quentin Grimes,SG,22,NYK,71,66,2121,282,602,157,407,125,195,78,98,49,180,229,150,47,26,69,177,799
184,Rui Hachimura,PF,24,TOT,63,9,1466,284,584,51,160,233,424,88,119,53,230,283,58,19,26,53,72,707
185,Tyrese Haliburton,PG,22,IND,56,56,1883,412,841,161,402,251,439,175,201,33,172,205,585,91,25,141,69,1160
186,Jordan Hall,SF,21,SAS,9,0,83,9,28,3,15,6,13,7,9,3,9,12,11,1,0,7,6,28
187,R.J. Hampton,SG,21,TOT,47,3,750,102,237,41,116,61,121,57,76,18,69,87,54,27,9,42,51,302
188,Tim Hardaway Jr.,SF,30,DAL,71,45,2152,340,847,212,550,128,297,127,165,21,230,251,129,49,12,60,120,1019
189,James Harden,PG,33,PHI,58,58,2135,371,842,161,418,210,424,313,361,40,314,354,618,71,31,195,112,1216
190,Jaden Hardy,SG,20,DAL,48,5,708,146,333,63,156,83,177,65,79,11,78,89,65,17,7,46,64,420
191,Ron Harper Jr.,PF,22,TOR,9,0,48,8,16,3,9,5,7,1,1,3,4,7,4,0,1,0,3,20
192,Montrezl Harrell,C,29,PHI,57,7,681,125,209,0,6,125,203,70,101,67,92,159,33,17,25,35,75,320
193,Gary Harris,SG,28,ORL,48,42,1184,138,307,94,218,44,89,27,30,21,77,98,59,45,12,28,93,397
194,Joe Harris,SF,31,BRK,74,33,1527,201,440,142,333,59,107,18,28,23,141,164,101,34,13,41,140,562
195,Kevon Harris,SG,25,ORL,34,0,457,47,107,16,43,31,64,31,41,28,42,70,16,17,5,21,53,141
196,Tobias Harris,SF,30,PHI,74,74,2436,423,845,126,324,297,521,113,129,67,357,424,186,68,40,89,149,1085
197,Shaquille Harrison,SG,29,POR,5,0,120,15,36,3,10,12,26,11,15,1,21,22,30,11,2,6,12,44
198,Josh Hart,SF,27,TOT,76,52,2454,275,520,61,164,214,356,132,176,142,451,593,290,88,21,117,195,743
199,Isaiah Hartenstein,C,24,NYK,82,8,1626,175,327,8,37,167,290,48,71,209,327,536,102,53,64,66,213,406
200,Udonis Haslem,C,42,MIA,7,1,71,10,29,3,9,7,20,4,5,4,7,11,0,1,2,1,11,27
201,Sam Hauser,SF,25,BOS,80,8,1290,180,396,140,335,40,61,12,17,35,169,204,71,29,21,30,99,512
202,Jaxson Hayes,C,22,NOP,47,2,610,86,156,3,29,83,127,58,83,39,93,132,34,20,19,31,67,233
203,Killian Hayes,PG,21,DET,76,56,2154,307,815,80,286,227,529,92,112,28,193,221,470,104,28,173,219,786
204,Gordon Hayward,SF,32,CHO,50,50,1577,276,581,52,160,224,421,129,159,33,182,215,206,42,12,99,70,733
205,Juancho Hernangómez,PF,27,TOR,42,10,614,48,114,17,67,31,47,9,16,27,96,123,25,16,6,15,43,122
206,Willy Hernangómez,C,28,NOP,38,2,458,89,169,3,11,86,158,81,104,58,122,180,33,17,13,39,64,262
207,Tyler Herro,SG,23,MIA,67,67,2337,487,1109,203,537,284,572,170,182,27,333,360,280,51,16,158,101,1347
208,Buddy Hield,SF,30,IND,80,73,2482,475,1038,288,677,187,361,106,129,67,333,400,225,92,26,139,156,1344
209,Haywood Highsmith,PF,26,MIA,54,11,969,93,216,37,109,56,107,13,28,57,131,188,43,36,17,45,82,236
210,George Hill,PG-SG,36,TOT,46,1,834,78,166,34,95,44,71,42,55,15,70,85,110,26,6,34,55,232
211,Malcolm Hill,SF,27,CHI,5,0,9,2,4,1,3,1,1,0,0,0,3,3,0,0,0,0,1,5
212,Aaron Holiday,PG,26,ATL,63,6,845,92,220,36,88,56,132,27,32,25,49,74,89,37,12,36,79,247
213,Jrue Holiday,PG,32,MIL,67,65,2183,490,1023,158,411,332,612,152,177,79,262,341,495,79,25,197,116,1290
214,Justin Holiday,SF,33,TOT,46,2,706,77,204,46,143,31,61,5,8,5,50,55,41,19,19,22,68,205
215,Richaun Holmes,C,29,SAC,42,1,348,55,89,5,8,50,81,15,19,29,51,80,9,3,11,14,50,130
216,Al Horford,C,36,BOS,63,63,1922,228,479,145,325,83,154,15,21,73,317,390,189,30,61,37,121,616
217,Talen Horton-Tucker,SG,22,UTA,65,20,1313,257,613,58,203,199,410,126,168,41,169,210,246,41,29,126,108,698
218,Danuel House Jr.,SF,29,PHI,56,5,807,93,197,37,110,56,87,45,60,9,85,94,44,14,9,26,69,268
219,Caleb Houstan,SF,20,ORL,51,4,812,66,182,46,136,20,46,15,18,34,65,99,30,12,7,18,63,193
220,Trevor Hudgins,PG,23,HOU,5,0,28,2,9,2,8,0,1,3,3,0,0,0,3,0,0,1,1,9
221,Kevin Huerter,SG,24,SAC,75,75,2203,420,866,205,510,215,356,95,131,42,209,251,221,80,24,97,181,1140
222,Jay Huff,C,24,WAS,7,0,95,15,25,6,12,9,13,15,16,6,15,21,10,3,4,5,15,51
223,De'Andre Hunter,SF,25,ATL,67,67,2126,379,822,100,286,279,536,171,207,46,238,284,94,35,17,82,199,1029
224,Bones Hyland,PG,22,TOT,56,1,1085,228,571,117,315,111,256,86,102,20,115,135,172,39,15,82,96,659
225,Serge Ibaka,C,33,MIL,16,0,185,26,54,6,18,20,36,8,13,15,29,44,4,2,7,11,23,66
226,Andre Iguodala,PF,39,GSW,8,0,113,7,15,1,9,6,6,2,3,3,14,17,19,4,3,9,11,17
227,Joe Ingles,SF,35,MIL,46,0,1044,108,248,83,203,25,45,18,21,13,115,128,150,33,6,55,74,317
228,Brandon Ingram,SF,25,NOP,45,45,1538,404,835,64,164,340,671,240,272,23,223,246,262,32,19,148,116,1112
229,Kyrie Irving,PG-SG,30,TOT,60,60,2241,594,1203,188,496,406,707,247,273,59,245,304,331,66,45,128,165,1623
230,Jonathan Isaac,PF,25,ORL,11,0,124,22,53,6,15,16,38,5,9,15,29,44,6,14,4,4,5,55
231,Jaden Ivey,SG,20,DET,74,73,2304,409,983,120,350,289,633,266,356,73,215,288,387,61,17,237,242,1204
232,Frank Jackson,PG,24,UTA,1,0,5,0,3,0,1,0,2,0,0,1,1,2,1,0,0,0,0,0
233,Isaiah Jackson,C,21,IND,63,12,1042,179,318,2,14,177,304,95,146,113,169,282,51,31,93,51,154,455
234,Jaren Jackson Jr.,C,23,MEM,63,63,1787,416,822,100,282,316,540,241,306,108,318,426,60,65,189,107,227,1173
235,Justin Jackson,SF,27,BOS,23,0,107,7,27,5,20,2,7,1,2,2,15,17,9,4,4,2,7,20
236,Quenton Jackson,PG,24,WAS,9,0,135,19,42,1,12,18,30,17,22,2,6,8,15,4,1,4,10,56
237,Reggie Jackson,PG,32,TOT,68,40,1657,263,640,96,288,167,352,71,78,25,119,144,233,47,6,115,114,693
238,LeBron James,PF,38,LAL,55,54,1954,609,1219,121,377,488,842,251,327,65,392,457,375,50,32,178,88,1590
239,Ty Jerome,SG,25,GSW,45,2,816,118,242,35,90,83,152,38,41,7,71,78,135,23,5,30,64,309
240,Isaiah Joe,SG,23,OKC,73,10,1395,224,508,161,394,63,114,82,100,27,148,175,88,48,8,39,105,691
241,Alize Johnson,PF,26,SAS,4,0,30,3,6,0,2,3,4,1,2,2,8,10,1,1,0,4,3,7
242,Cameron Johnson,PF,26,TOT,42,41,1199,223,474,103,255,120,219,101,120,34,151,185,78,50,14,37,83,650
243,Jalen Johnson,SF,21,ATL,70,6,1042,158,322,30,104,128,218,49,78,51,231,282,83,38,34,41,113,395
244,James Johnson,PF,35,IND,18,1,162,22,49,3,15,19,34,4,8,4,26,30,15,7,6,8,32,51
245,Keldon Johnson,SF,23,SAS,63,63,2063,503,1113,134,407,369,706,245,327,56,262,318,183,46,11,134,125,1385
246,Keon Johnson,SG,20,POR,40,0,416,67,178,28,81,39,97,27,41,11,33,44,59,19,6,43,43,189
247,Stanley Johnson,SF,26,SAS,30,0,469,65,122,18,40,47,82,26,39,22,73,95,67,16,6,33,48,174
248,Nikola Jokić,C,27,DEN,69,69,2323,646,1022,57,149,589,873,341,415,167,650,817,678,87,47,247,174,1690
249,Carlik Jones,PG,25,CHI,7,0,56,6,15,3,6,3,9,5,8,1,4,5,6,2,0,2,2,20
250,Damian Jones,C,27,TOT,41,1,477,55,86,10,17,45,69,22,29,42,80,122,15,8,21,23,55,142
251,Derrick Jones Jr.,PF,25,CHI,64,0,893,115,230,27,80,88,150,62,84,60,93,153,34,29,37,25,86,319
252,Herbert Jones,PF,24,NOP,66,66,1951,235,501,56,167,179,334,123,161,97,172,269,162,103,42,88,208,649
253,Kai Jones,C,22,CHO,46,0,550,67,120,4,19,63,101,19,26,37,86,123,15,17,30,31,65,157
254,Tre Jones,PG,23,SAS,68,65,1984,341,743,45,158,296,585,148,172,56,189,245,448,89,9,110,98,875
255,Tyus Jones,PG,26,MEM,80,22,1940,311,710,121,326,190,384,80,100,28,172,200,417,83,6,74,32,823
256,DeAndre Jordan,C,34,DEN,39,8,586,88,115,1,1,87,114,22,48,52,150,202,34,12,23,48,71,199
257,Cory Joseph,PG,31,DET,62,2,1227,150,351,70,180,80,171,57,72,21,85,106,217,34,9,56,88,427
258,Nikola Jović,PF,19,MIA,15,8,204,28,69,8,35,20,34,18,19,9,22,31,10,7,2,10,19,82
259,Johnny Juzang,SG,21,UTA,18,0,232,35,104,15,63,20,41,2,4,8,31,39,8,4,3,3,13,87
260,Mfiondu Kabengele,PF,25,BOS,4,0,36,2,7,0,3,2,4,2,2,5,5,10,0,2,0,1,3,6
261,Frank Kaminsky,C,29,TOT,36,0,235,31,63,13,33,18,30,14,16,7,45,52,32,6,4,9,22,89
262,Trevor Keels,SG,19,NYK,3,0,8,1,4,1,4,0,0,0,0,0,2,2,0,0,0,0,0,3
263,Luke Kennard,SG,26,TOT,59,14,1315,188,382,133,269,55,113,37,39,15,143,158,91,32,5,46,82,546
264,Walker Kessler,C,21,UTA,74,40,1703,298,414,1,3,297,411,82,159,231,389,620,69,26,173,58,169,679
265,Braxton Key,SF,25,DET,3,0,9,1,1,0,0,1,1,2,2,0,1,1,0,0,0,0,0,4
266,Louis King,PF,23,PHI,1,0,29,8,13,4,8,4,5,0,1,2,2,4,2,1,0,2,4,20
267,Corey Kispert,SF,23,WAS,74,45,2093,291,585,163,384,128,201,75,88,33,174,207,87,32,9,55,97,820
268,Maxi Kleber,PF,31,DAL,37,5,930,77,169,39,112,38,57,27,38,30,105,135,52,12,30,27,85,220
269,Nathan Knight,C,25,MIN,38,0,291,46,81,8,22,38,59,39,57,22,34,56,13,10,6,21,41,139
270,Kevin Knox,SF-PF,23,TOT,63,5,952,152,332,65,186,87,146,46,60,34,143,177,33,24,12,50,95,415
271,Christian Koloko,C,22,TOR,58,19,802,72,150,1,12,71,138,37,59,84,87,171,31,21,57,20,128,182
272,John Konchar,SF,26,MEM,72,23,1494,138,320,60,177,78,143,28,36,64,246,310,100,77,25,37,112,364
273,Furkan Korkmaz,SG,25,PHI,37,0,353,48,111,18,46,30,65,26,36,6,36,42,22,10,3,24,18,140
274,Luke Kornet,C,27,BOS,69,0,804,113,170,3,13,110,157,32,39,86,111,197,53,11,46,25,81,261
275,Vit Krejci,PG,22,ATL,29,0,165,15,37,5,21,10,16,1,2,6,20,26,17,5,1,5,17,36
276,Jonathan Kuminga,PF,20,GSW,67,16,1394,261,497,54,146,207,351,90,138,70,161,231,125,41,31,95,157,666
277,Kyle Kuzma,PF,27,WAS,64,64,2239,512,1142,160,481,352,661,173,237,55,408,463,239,36,29,190,145,1357
278,Anthony Lamb,SF,25,GSW,62,4,1195,148,314,73,199,75,115,46,60,56,159,215,96,28,20,54,134,415
279,Jock Landale,C,27,PHO,69,4,979,178,337,21,84,157,253,79,105,119,161,280,68,16,30,59,126,456
280,Romeo Langford,SG,23,SAS,43,21,844,121,259,16,61,105,198,39,56,57,57,114,50,24,13,30,67,297
281,Jake LaRavia,PF,21,MEM,35,0,414,37,95,24,71,13,24,7,9,19,44,63,21,12,4,18,49,105
282,Zach LaVine,SG,27,CHI,77,77,2768,673,1388,204,544,469,844,363,428,42,303,345,327,69,18,194,159,1913
283,A.J. Lawson,SG,22,TOT,15,0,108,22,44,10,25,12,19,2,8,6,15,21,2,2,0,3,11,56
284,Damion Lee,SG,30,PHO,74,5,1506,200,452,110,247,90,205,94,104,39,186,225,99,30,7,78,118,604
285,Saben Lee,PG,23,TOT,25,1,373,49,121,11,30,38,91,42,57,13,32,45,67,19,1,24,32,151
286,Alex Len,C,29,SAC,26,2,161,16,30,0,2,16,28,11,16,24,36,60,12,4,11,16,28,43
287,Kawhi Leonard,SF,31,LAC,52,50,1748,446,871,104,250,342,621,243,279,57,281,338,204,72,28,88,84,1239
288,Meyers Leonard,C,30,MIL,9,2,114,14,29,7,18,7,11,8,9,12,22,34,1,2,0,6,16,43
289,Caris LeVert,SG,28,CLE,74,30,2237,320,742,127,324,193,418,130,180,53,229,282,287,72,24,116,170,897
290,Kira Lewis Jr.,PG,21,NOP,25,0,235,40,88,15,34,25,54,19,22,5,28,33,23,10,2,10,24,114
291,Damian Lillard,PG,32,POR,58,58,2107,556,1202,244,658,312,544,510,558,44,233,277,425,50,18,191,109,1866
292,Nassir Little,SF,22,POR,54,4,976,134,303,58,158,76,145,33,46,27,114,141,50,20,20,36,66,359
293,Isaiah Livers,PF,24,DET,52,22,1199,120,288,74,203,46,85,32,39,28,115,143,41,28,28,30,103,346
294,Kenneth Lofton Jr.,PF,20,MEM,24,1,176,49,93,6,17,43,76,16,27,19,32,51,20,5,2,12,28,120
295,Kevon Looney,C,26,GSW,82,70,1958,242,384,0,1,242,383,94,155,274,486,760,207,52,50,45,225,578
296,Brook Lopez,C,34,MIL,78,78,2373,477,899,136,364,341,535,149,190,157,363,520,99,37,193,107,203,1239
297,Robin Lopez,C,34,CLE,37,2,299,48,75,2,4,46,71,14,18,23,28,51,19,2,8,25,43,112
298,Kevin Love,PF,34,TOT,62,20,1240,165,424,99,296,66,128,80,91,59,340,399,116,16,12,70,97,509
299,Kyle Lowry,PG,36,MIA,55,44,1718,196,485,107,310,89,175,116,135,43,182,225,281,57,21,103,143,615
300,Trey Lyles,PF,27,SAC,74,0,1247,187,408,87,240,100,168,101,124,68,232,300,66,27,31,64,97,562
301,Théo Maledon,PG,21,CHO,44,7,854,102,254,28,95,74,159,63,74,14,109,123,152,37,12,59,61,295
302,Sandro Mamukelashvili,C,23,TOT,43,7,660,97,230,30,99,67,131,39,57,70,115,185,62,14,12,35,52,263
303,Terance Mann,SG,26,LAC,81,36,1872,272,524,77,198,195,326,92,118,77,199,276,184,42,22,80,149,713
304,Tre Mann,PG,21,OKC,67,5,1183,197,501,81,257,116,244,42,55,27,128,155,120,40,11,62,99,517
305,Boban Marjanović,C,34,HOU,31,0,171,41,60,0,1,41,59,20,27,20,40,60,9,5,2,14,10,102
306,Lauri Markkanen,PF,25,UTA,66,66,2273,571,1145,200,511,371,634,349,399,130,440,570,123,42,38,127,137,1691
307,Naji Marshall,SF,25,NOP,77,21,1792,247,571,66,218,181,353,138,175,48,231,279,189,54,14,97,113,698
308,Caleb Martin,SF,27,MIA,71,49,2077,254,548,84,236,170,312,91,113,88,256,344,117,71,31,78,145,683
309,Cody Martin,SF,27,CHO,7,0,134,14,36,3,14,11,22,4,7,8,16,24,11,4,1,2,13,35
310,Kenyon Martin Jr.,SF,22,HOU,82,49,2292,410,720,68,216,342,504,151,222,126,326,452,123,41,30,91,147,1039
311,Tyrese Martin,SG,23,ATL,16,0,66,9,23,1,7,8,16,2,2,5,7,12,2,1,0,2,2,21
312,Garrison Mathews,SG,26,TOT,54,0,686,73,201,63,180,10,21,48,53,11,62,73,26,24,5,19,62,257
313,Bennedict Mathurin,SG,20,IND,78,17,2222,413,951,100,310,313,641,376,454,87,231,318,116,48,13,152,162,1302
314,Wesley Matthews,SF,36,MIL,52,0,820,58,160,39,124,19,36,24,28,34,79,113,34,20,13,18,71,179
315,Tyrese Maxey,SG,22,PHI,60,41,2016,439,913,160,369,279,544,180,213,23,153,176,212,49,8,80,132,1218
316,Skylar Mays,PG,25,POR,6,6,189,34,68,12,26,22,42,12,13,2,17,19,50,6,1,10,11,92
317,Miles McBride,PG,22,NYK,64,2,760,77,215,40,134,37,81,28,42,13,37,50,72,37,8,25,60,222
318,Mac McClung,SG,24,PHI,2,0,41,9,20,4,11,5,9,3,5,3,7,10,9,0,0,3,3,25
319,CJ McCollum,SG,31,NOP,75,75,2649,587,1344,211,543,376,801,183,238,55,273,328,429,70,38,183,153,1568
320,T.J. McConnell,PG,30,IND,75,6,1526,283,521,26,59,257,462,58,68,45,189,234,397,81,10,143,105,650
321,Jaden McDaniels,SF,22,MIN,79,79,2416,370,716,107,269,263,447,106,144,92,215,307,148,74,76,112,272,953
322,Jalen McDaniels,SF,25,TOT,80,24,1913,281,617,77,232,204,385,116,138,63,283,346,130,83,34,93,209,755
323,Doug McDermott,SF,31,SAS,64,0,1314,239,523,123,298,116,225,53,70,24,115,139,91,13,6,58,118,654
324,JaVale McGee,C,35,DAL,42,7,355,80,125,2,5,78,120,24,41,30,77,107,11,4,26,36,54,186
325,Bryce McGowens,SG,20,CHO,46,7,787,80,202,26,80,54,122,60,80,20,73,93,54,15,6,43,48,246
326,Rodney McGruder,SG,31,DET,32,12,524,62,152,41,97,21,55,18,22,20,54,74,28,16,1,11,39,183
327,Jordan McLaughlin,PG,26,MIN,43,0,678,61,145,24,78,37,67,15,18,15,47,62,148,32,4,33,28,161
328,De'Anthony Melton,SG,24,PHI,77,58,2150,277,651,157,403,120,248,69,87,69,243,312,197,126,41,102,191,780
329,Sam Merrill,SG,26,CLE,5,0,59,9,22,5,18,4,4,2,2,0,9,9,5,4,0,0,3,25
330,Chimezie Metu,PF,25,SAC,66,0,689,129,219,9,38,120,181,54,73,47,151,198,40,22,21,32,81,321
331,Khris Middleton,SF,31,MIL,33,19,801,177,406,51,162,126,244,92,102,28,112,140,163,23,5,71,68,497
332,Patty Mills,PG,34,BRK,40,2,567,86,209,49,134,37,75,25,30,8,36,44,56,15,3,30,32,246
333,Shake Milton,SG,26,PHI,76,11,1567,241,503,56,148,185,355,99,116,39,152,191,240,25,13,94,123,637
334,Justin Minaya,SF,23,POR,4,0,89,7,23,3,12,4,11,0,1,3,12,15,4,2,5,4,9,17
335,Josh Minott,SF,20,MIN,15,0,96,18,36,2,6,16,30,8,8,5,20,25,5,4,6,3,10,46
336,Davion Mitchell,PG,24,SAC,80,9,1447,181,399,63,197,118,202,25,31,16,89,105,185,44,15,62,112,450
337,Donovan Mitchell,SG,26,CLE,68,68,2432,679,1402,245,635,434,767,319,368,63,226,289,301,99,27,180,168,1922
338,Evan Mobley,PF,21,CLE,79,79,2715,525,947,22,102,503,845,205,304,187,524,711,224,60,119,146,218,1277
339,Isaiah Mobley,PF,23,CLE,12,0,84,12,28,3,8,9,20,4,4,4,16,20,3,4,3,1,8,31
340,Chima Moneke,SF,27,SAC,2,0,8,1,2,0,0,1,2,0,2,2,0,2,1,0,0,2,2,2
341,Malik Monk,SG,24,SAC,77,0,1719,357,796,143,398,214,398,184,207,32,171,203,298,49,20,146,125,1041
342,Moses Moody,SG,20,GSW,63,3,817,108,227,49,135,59,92,37,53,28,77,105,51,18,7,34,54,302
343,Xavier Moon,SG,28,LAC,4,0,20,3,9,1,3,2,6,0,0,0,3,3,5,0,0,1,2,7
344,Wendell Moore Jr.,SG,21,MIN,29,2,153,18,43,2,17,16,26,4,5,4,14,18,18,8,5,8,13,42
345,Ja Morant,PG,23,MEM,61,59,1948,566,1214,92,300,474,914,372,497,61,296,357,493,66,16,206,100,1596
346,Marcus Morris,PF,33,LAC,65,65,1825,274,643,112,308,162,335,68,87,29,229,258,114,42,21,56,136,728
347,Markieff Morris,PF,33,TOT,35,2,355,47,115,28,71,19,44,10,10,13,58,71,31,9,5,18,48,132
348,Monte Morris,PG,27,WAS,62,61,1695,247,515,78,204,169,311,64,77,26,184,210,326,43,13,60,75,636
349,Trey Murphy III,SF,22,NOP,79,65,2448,387,800,202,497,185,303,172,190,59,222,281,112,89,43,61,155,1148
350,Dejounte Murray,SG,26,ATL,74,74,2693,612,1319,133,387,479,932,158,190,53,336,389,448,112,19,160,106,1515
351,Jamal Murray,PG,25,DEN,65,65,2133,473,1041,172,432,301,609,180,216,48,209,257,400,66,16,145,103,1298
352,Keegan Murray,SF,22,SAC,80,78,2382,354,782,206,501,148,281,62,81,89,282,371,98,61,42,60,162,976
353,Mike Muscala,C,31,TOT,63,9,945,131,292,81,207,50,85,40,52,37,166,203,50,15,24,23,98,383
354,Svi Mykhailiuk,SF,25,TOT,32,8,468,77,173,42,99,35,74,26,39,15,38,53,53,15,4,24,23,222
355,Larry Nance Jr.,C,30,NOP,65,1,1381,186,305,14,42,172,263,55,79,106,248,354,119,56,37,42,133,441
356,Andrew Nembhard,SG,23,IND,75,63,2073,284,644,92,263,192,381,49,62,35,164,199,341,70,13,126,179,709
357,Aaron Nesmith,SF,23,IND,73,60,1816,252,590,115,314,137,276,119,142,62,215,277,98,55,34,75,235,738
358,Raul Neto,PG,30,CLE,48,1,505,57,110,12,42,45,68,31,34,10,36,46,79,17,4,24,49,157
359,Georges Niang,PF,29,PHI,78,1,1512,222,502,154,384,68,118,39,45,19,166,185,77,30,14,54,145,637
360,Daishen Nix,PG,20,HOU,57,7,914,81,237,40,140,41,97,24,36,18,80,98,132,31,7,86,59,226
361,Zeke Nnaji,PF,22,DEN,53,5,728,110,196,17,65,93,131,40,62,65,73,138,18,17,23,31,105,277
362,Nerlens Noel,C,28,TOT,17,4,195,13,36,1,2,12,34,8,12,10,36,46,10,16,10,13,32,35
363,Jaylen Nowell,SG,23,MIN,65,2,1252,280,625,67,232,213,393,77,99,36,134,170,132,42,5,65,101,704
364,Frank Ntilikina,SG,24,DAL,47,5,607,48,132,17,67,31,65,22,33,7,55,62,58,16,7,29,65,135
365,Kendrick Nunn,SG,27,TOT,70,2,964,191,450,79,223,112,227,35,41,15,94,109,90,28,7,66,66,496
366,Jusuf Nurkić,C,28,POR,52,52,1391,262,505,43,119,219,386,127,192,114,357,471,149,43,44,119,185,694
367,Jordan Nwora,SF,24,TOT,62,14,1188,194,445,86,211,108,234,68,86,51,178,229,88,24,14,66,74,542
368,Royce O'Neale,SF,29,BRK,76,53,2409,229,593,163,419,66,174,50,69,55,329,384,283,65,49,114,239,671
369,Chuma Okeke,SF,24,ORL,27,8,518,43,122,26,86,17,36,16,21,26,70,96,37,19,11,17,40,128
370,Josh Okogie,SG,24,PHO,72,26,1350,162,414,66,197,96,217,139,192,109,142,251,105,56,34,63,114,529
371,Onyeka Okongwu,C,22,ATL,80,18,1849,317,497,4,13,313,484,153,196,217,359,576,81,56,107,81,251,791
372,Isaac Okoro,SF,22,CLE,76,46,1652,175,354,62,171,113,183,78,103,52,135,187,87,56,30,42,158,490
373,KZ Okpala,PF,23,SAC,35,3,248,16,38,7,21,9,17,7,8,7,27,34,13,7,7,7,39,46
374,Victor Oladipo,SG,30,MIA,42,2,1106,160,403,70,212,90,191,59,79,16,112,128,146,57,12,87,99,449
375,Kelly Olynyk,C,31,UTA,68,68,1942,278,557,93,236,185,321,198,232,82,338,420,252,60,37,168,232,847
376,Eugene Omoruyi,SF,25,TOT,40,6,645,101,228,25,89,76,139,51,75,43,68,111,28,28,3,34,91,278
377,Cedi Osman,SF,27,CLE,77,2,1548,239,530,116,312,123,218,75,108,25,151,176,115,35,11,52,122,669
378,Kelly Oubre Jr.,SF,27,CHO,48,40,1548,353,819,108,339,245,480,158,208,65,184,249,54,68,18,64,141,972
379,Chris Paul,PG,37,PHO,59,59,1889,294,668,98,261,196,407,133,160,27,224,251,524,91,22,114,126,819
380,Cameron Payne,PG,28,PHO,48,15,968,188,453,68,185,120,268,49,64,12,94,106,214,33,8,81,88,493
381,Gary Payton II,SG,30,TOT,22,1,367,41,69,13,26,28,43,6,7,24,45,69,30,22,5,16,43,101
382,Theo Pinson,SG,27,DAL,40,1,323,31,87,22,62,9,25,11,13,10,53,63,46,6,1,12,34,95
383,Scotty Pippen Jr.,PG,22,LAL,6,0,32,4,12,1,3,3,9,5,9,2,2,4,2,2,1,2,3,14
384,Mason Plumlee,C,32,TOT,79,60,2054,329,484,0,0,329,484,199,313,229,471,700,245,46,47,117,217,857
385,Jakob Poeltl,C,27,TOT,72,71,1906,389,618,0,1,389,617,119,201,236,417,653,197,66,86,125,195,897
386,Aleksej Pokusevski,PF,21,OKC,34,25,701,108,249,38,104,70,145,22,35,45,114,159,64,20,43,43,58,276
387,Jordan Poole,PG,23,GSW,82,43,2458,550,1278,214,637,336,641,361,415,32,193,225,369,63,21,252,214,1675
388,Kevin Porter Jr.,PG,22,HOU,59,59,2024,391,884,141,385,250,499,207,264,76,238,314,338,82,17,188,156,1130
389,Michael Porter Jr.,SF,24,DEN,62,62,1798,398,817,188,454,210,363,96,120,64,277,341,65,37,29,68,119,1080
390,Otto Porter Jr.,SF,29,TOR,8,2,146,15,30,6,17,9,13,8,8,6,13,19,8,11,0,4,7,44
391,Bobby Portis,PF,27,MIL,70,22,1818,398,803,95,257,303,546,96,125,154,518,672,105,29,16,81,115,987
392,Kristaps Porziņģis,C,27,WAS,65,65,2120,507,1018,137,356,370,662,354,416,114,432,546,174,58,100,137,196,1505
393,Micah Potter,PF,24,UTA,7,0,52,10,15,4,7,6,8,0,0,3,13,16,4,1,0,2,5,24
394,Dwight Powell,C,31,DAL,76,64,1458,197,269,0,5,197,264,112,168,149,165,314,69,48,26,65,209,506
395,Norman Powell,SG,29,LAC,60,8,1567,340,710,114,287,226,423,225,277,24,151,175,109,50,18,101,125,1019
396,Jason Preston,PG,23,LAC,14,0,124,18,41,5,18,13,23,0,2,2,20,22,27,2,0,10,7,41
397,Joshua Primo,SG,20,SAS,4,0,93,9,26,3,12,6,14,7,9,2,11,13,18,1,2,11,8,28
398,Taurean Prince,PF,28,MIN,54,4,1192,177,379,74,194,103,185,65,77,15,117,132,84,28,15,69,123,493
399,Payton Pritchard,PG,25,BOS,48,3,643,101,245,56,154,45,91,12,16,25,63,88,64,14,1,40,37,270
400,Trevelin Queen,SG,25,IND,7,0,70,7,29,2,15,5,14,5,5,8,9,17,6,2,5,7,4,21
401,Neemias Queta,C,23,SAC,5,0,29,6,9,0,0,6,9,0,2,5,6,11,1,0,2,1,7,12
402,Immanuel Quickley,SG,23,NYK,81,21,2344,419,936,168,454,251,482,203,248,58,279,337,279,80,14,100,166,1209
403,Lester Quinones,SG,22,GSW,4,0,18,2,5,2,4,0,1,4,6,1,2,3,2,1,0,5,0,10
404,Julius Randle,PF,28,NYK,77,77,2737,658,1432,218,636,440,796,402,531,141,626,767,316,49,21,216,233,1936
405,Austin Reaves,SG,24,LAL,64,22,1843,259,490,86,216,173,274,229,265,33,160,193,215,33,19,99,108,833
406,Cam Reddish,SF,23,TOT,40,20,990,139,312,45,144,94,168,64,75,18,70,88,57,39,14,47,72,387
407,Davon Reed,SG,27,TOT,43,1,342,28,84,17,46,11,38,16,24,10,49,59,23,15,4,20,39,89
408,Paul Reed,C,23,PHI,69,2,755,124,209,1,6,123,203,38,51,112,150,262,27,46,51,45,123,287
409,Naz Reid,C,23,MIN,68,11,1251,310,577,75,217,235,360,86,127,73,260,333,77,42,53,92,176,781
410,Jared Rhoden,SG,23,DET,14,0,198,17,44,5,20,12,24,6,6,11,26,37,4,4,1,3,23,45
411,Nick Richards,C,25,CHO,65,9,1217,197,313,1,1,196,312,137,183,147,269,416,38,11,71,59,154,532
412,Josh Richardson,SG,29,TOT,65,10,1530,239,554,107,293,132,261,69,81,41,134,175,174,69,20,86,117,654
413,Austin Rivers,SG,30,MIN,52,10,1016,91,209,43,123,48,86,30,39,5,78,83,75,28,4,23,80,255
414,Duncan Robinson,SF,28,MIA,42,1,691,88,237,63,192,25,45,29,32,8,61,69,46,14,0,28,77,268
415,Mitchell Robinson,C,24,NYK,59,58,1591,188,280,0,0,188,280,59,122,267,288,555,53,56,109,41,160,435
416,Orlando Robinson,C,22,MIA,31,1,425,47,89,0,6,47,83,22,31,48,78,126,25,12,12,16,53,116
417,Jeremiah Robinson-Earl,PF,22,OKC,43,20,814,110,248,37,111,73,137,35,42,71,109,180,43,24,11,19,71,292
418,Isaiah Roby,PF,24,SAS,42,2,474,67,155,18,60,49,95,20,41,21,86,107,38,18,7,31,53,172
419,David Roddy,PF,21,MEM,70,4,1258,180,420,65,212,115,208,41,65,50,143,193,59,29,19,57,107,466
420,Ryan Rollins,PG,20,GSW,12,0,62,7,20,3,9,4,11,6,6,3,9,12,6,1,1,16,10,23
421,Derrick Rose,PG,34,NYK,27,0,338,61,159,19,63,42,96,11,12,8,32,40,46,7,5,22,18,152
422,Terrence Ross,SG,31,TOT,63,9,1330,200,465,95,258,105,207,27,34,22,132,154,95,35,10,43,97,522
423,Terry Rozier,SG,28,CHO,63,63,2221,493,1188,165,505,328,683,178,220,51,208,259,319,74,16,134,119,1329
424,Ricky Rubio,PG,32,CLE,33,2,566,61,178,21,82,40,96,28,35,9,61,70,115,26,6,31,51,171
425,D'Angelo Russell,PG,26,TOT,71,71,2304,445,948,194,490,251,458,179,216,35,180,215,437,70,29,186,140,1263
426,Matt Ryan,SF,25,TOT,34,0,310,40,108,32,84,8,24,10,12,4,22,26,16,5,1,7,27,122
427,Domantas Sabonis,C,26,SAC,79,79,2736,577,938,31,83,546,855,325,438,251,722,973,573,65,39,230,279,1510
428,Luka Šamanić,PF,23,UTA,7,4,161,26,57,8,31,18,26,9,13,0,30,30,15,6,2,10,17,69
429,Dario Šarić,PF-C,28,TOT,57,12,806,127,277,45,115,82,162,63,76,53,154,207,74,20,7,55,99,362
430,Olivier Sarr,C,23,OKC,9,1,114,15,30,1,8,14,22,5,7,12,19,31,4,1,5,4,17,36
431,Jordan Schakel,SF,24,WAS,2,0,6,1,2,1,1,0,1,0,0,0,0,0,1,1,0,0,1,3
432,Admiral Schofield,PF,25,ORL,37,0,451,55,122,24,74,31,48,21,23,23,39,62,31,8,5,16,61,155
433,Dennis Schröder,PG,29,LAL,66,50,1986,270,650,74,225,196,425,216,252,21,144,165,298,50,10,112,145,830
434,Jay Scrubb,SG,22,ORL,2,0,30,5,7,2,2,3,5,1,2,0,6,6,1,2,0,3,2,13
435,Dereon Seabron,SG,22,NOP,5,0,12,2,5,0,0,2,5,0,0,1,0,1,0,0,0,0,1,4
436,Alperen Şengün,C,20,HOU,75,72,2171,442,799,19,57,423,742,206,288,242,436,678,291,70,70,193,258,1109
437,Collin Sexton,PG,24,UTA,48,15,1145,237,468,48,122,189,346,163,199,37,68,105,138,27,6,85,112,685
438,Landry Shamet,SG,25,PHO,40,9,807,113,300,75,199,38,101,45,51,11,56,67,93,26,5,36,61,346
439,Day'Ron Sharpe,C,21,BRK,48,3,552,93,171,6,11,87,160,35,55,99,101,200,37,15,32,42,89,227
440,Shaedon Sharpe,SG,19,POR,80,15,1779,306,648,102,283,204,365,75,105,63,173,236,94,38,24,83,136,789
441,Pascal Siakam,PF,28,TOR,71,71,2652,630,1313,93,287,537,1026,367,474,131,425,556,415,65,36,169,228,1720
442,Chris Silva,PF,26,DAL,1,0,3,1,1,0,0,1,1,0,0,0,0,0,0,0,0,1,2,2
443,Ben Simmons,PG,26,BRK,42,33,1105,133,235,0,2,133,233,25,57,40,223,263,256,54,24,97,139,291
444,Kobi Simmons,SG,25,CHO,5,0,28,1,6,1,5,0,1,2,2,1,3,4,5,0,2,1,0,5
445,Marko Simonovic,C,23,CHI,7,0,20,2,7,1,4,1,3,1,2,1,1,2,0,0,0,0,5,6
446,Anfernee Simons,SG,23,POR,62,62,2171,467,1045,212,562,255,483,160,179,18,143,161,253,42,14,128,142,1306
447,Jericho Sims,C,24,NYK,52,16,812,83,107,0,1,83,106,12,16,99,143,242,25,15,28,27,96,178
448,Marcus Smart,PG,28,BOS,61,61,1957,250,602,115,342,135,260,88,118,46,145,191,382,93,23,143,172,703
449,Dennis Smith Jr.,PG,25,CHO,54,15,1390,186,452,24,111,162,341,78,106,27,140,167,261,75,25,82,122,474
450,Dru Smith,SG,25,TOT,15,1,158,18,45,5,19,13,26,3,3,2,22,24,22,10,4,3,23,44
451,Ish Smith,PG,34,DEN,43,0,398,52,131,2,12,50,119,2,4,5,49,54,100,8,7,44,33,108
452,Jabari Smith Jr.,PF,19,HOU,79,79,2451,364,892,120,391,244,501,162,206,122,447,569,101,43,74,104,227,1010
453,Jalen Smith,C,22,IND,68,31,1279,242,508,54,191,188,317,104,137,129,265,394,66,21,60,72,153,642
454,Xavier Sneed,SF,25,CHO,4,0,48,5,10,3,6,2,4,4,4,0,5,5,5,0,1,3,7,17
455,Jeremy Sochan,PF,19,SAS,56,53,1458,250,552,33,134,217,418,81,116,95,200,295,142,43,23,97,138,614
456,Jaden Springer,SG,20,PHI,16,2,89,17,35,2,5,15,30,6,8,6,8,14,8,7,3,3,15,42
457,Lamar Stevens,SF,25,CLE,62,25,1120,129,288,30,95,99,193,40,57,48,159,207,33,27,19,27,79,328
458,Isaiah Stewart,C,21,DET,50,47,1414,195,441,67,205,128,236,110,149,115,288,403,70,20,34,68,133,567
459,Max Strus,SF,26,MIA,80,33,2272,324,790,197,563,127,227,78,89,49,209,258,171,42,12,70,166,923
460,Jalen Suggs,SG,21,ORL,53,19,1246,186,444,66,202,120,242,86,119,55,106,161,155,67,27,94,120,524
461,Edmond Sumner,SG,27,BRK,53,12,736,124,269,31,87,93,182,99,108,13,66,79,68,31,10,50,83,378
462,Cole Swider,SF,23,LAL,7,0,41,3,9,3,8,0,1,0,0,1,6,7,4,0,0,0,3,9
463,Jae'Sean Tate,SF,27,HOU,31,7,677,110,229,13,46,97,183,50,69,41,77,118,84,21,7,47,106,283
464,Jayson Tatum,SF,24,BOS,74,74,2732,727,1559,240,686,487,873,531,622,78,571,649,342,78,51,213,160,2225
465,Terry Taylor,PF,23,TOT,31,2,264,39,75,5,19,34,56,6,11,27,20,47,10,3,6,9,26,89
466,Garrett Temple,SG,36,NOP,25,0,162,18,45,11,26,7,19,3,4,5,12,17,13,9,2,4,15,50
467,Dalen Terry,SG,20,CHI,38,0,214,32,72,7,27,25,45,14,21,12,25,37,22,11,5,8,24,85
468,Daniel Theis,C,30,IND,7,1,109,21,44,2,11,19,33,5,12,7,15,22,9,2,6,3,7,49
469,Cam Thomas,SG,21,BRK,57,4,948,201,456,51,133,150,323,151,174,8,87,95,78,20,7,63,55,604
470,Klay Thompson,SF,32,GSW,69,69,2279,546,1252,301,731,245,521,116,132,39,247,286,163,49,29,123,130,1509
471,JT Thor,PF,20,CHO,69,8,969,95,238,39,123,56,115,33,47,36,116,152,36,22,23,44,66,262
472,Matisse Thybulle,SF-SG,25,TOT,71,28,1200,110,253,54,148,56,105,19,28,40,100,140,53,83,32,24,113,293
473,Xavier Tillman Sr.,C,24,MEM,61,29,1180,188,306,4,15,184,291,49,89,121,186,307,96,58,29,44,97,429
474,Isaiah Todd,PF,21,WAS,6,1,61,3,19,1,10,2,9,2,2,2,10,12,4,1,0,2,4,9
475,Obi Toppin,PF,24,NYK,67,5,1050,187,419,85,247,102,172,38,47,29,158,187,66,23,12,38,68,497
476,Juan Toscano-Anderson,SF,29,TOT,52,9,700,64,143,8,43,56,100,19,24,28,96,124,65,16,10,34,80,155
477,Karl-Anthony Towns,PF,27,MIN,29,29,957,212,428,60,164,152,264,118,135,48,188,236,140,20,17,86,111,602
478,Gary Trent Jr.,SG,24,TOR,66,44,2118,405,935,166,450,239,485,172,205,30,143,173,106,104,14,55,102,1148
479,P.J. Tucker,PF,37,PHI,75,75,1920,96,225,55,140,41,85,19,23,95,200,295,60,39,15,44,180,266
480,Myles Turner,C,26,IND,62,62,1825,402,733,93,249,309,484,216,276,88,378,466,89,36,140,103,215,1113
481,Stanley Umude,SG,23,DET,1,0,2,0,1,0,1,0,0,2,2,0,0,0,0,1,1,0,0,2
482,Jonas Valančiūnas,C,30,NOP,79,79,1968,446,816,38,109,408,707,185,224,225,579,804,140,20,52,159,245,1115
483,Jarred Vanderbilt,PF,23,TOT,78,65,1879,247,451,29,90,218,361,96,139,170,412,582,184,83,21,97,190,619
484,Fred VanVleet,PG,28,TOR,69,69,2535,437,1112,207,606,230,506,254,283,30,250,280,495,123,38,140,193,1335
485,Devin Vassell,SG,22,SAS,38,32,1178,261,595,103,266,158,329,78,100,8,140,148,136,43,17,57,57,703
486,Gabe Vincent,PG,26,MIA,68,34,1759,228,567,117,350,111,217,68,78,27,118,145,167,62,5,92,154,641
487,Noah Vonleh,C,27,BOS,23,1,171,11,24,1,4,10,20,2,2,18,30,48,7,2,8,11,35,25
488,Nikola Vučević,C,32,CHI,82,82,2746,597,1148,121,347,476,801,132,158,159,744,903,265,60,57,139,179,1447
489,Dean Wade,PF,26,CLE,44,13,891,73,177,45,127,28,50,15,23,20,130,150,37,28,21,17,89,206
490,Franz Wagner,SF,21,ORL,80,80,2609,542,1118,130,360,412,758,271,322,70,259,329,283,77,17,167,183,1485
491,Moritz Wagner,C,25,ORL,57,18,1109,198,396,51,163,147,233,153,182,69,190,259,84,37,13,68,136,600
492,Ish Wainright,SF,28,PHO,60,2,915,84,227,57,173,27,54,26,31,45,94,139,53,38,22,22,117,251
493,Jabari Walker,SF,20,POR,56,0,619,83,198,16,56,67,142,34,45,48,83,131,34,10,13,29,69,216
494,Kemba Walker,PG,32,DAL,9,1,144,24,57,7,28,17,29,17,21,3,13,16,19,2,2,4,11,72
495,Lonnie Walker IV,SG,24,LAL,56,32,1297,236,527,91,249,145,278,91,106,14,95,109,64,30,17,46,71,654
496,John Wall,PG,32,LAC,34,3,755,138,338,33,109,105,229,77,113,14,78,92,178,27,12,80,59,386
497,T.J. Warren,PF-SF,29,TOT,42,0,687,132,270,22,67,110,203,28,35,26,95,121,40,22,12,20,65,314
498,Duane Washington Jr.,SG,22,PHO,31,3,394,94,256,40,111,54,145,16,24,2,34,36,63,6,4,34,23,244
499,P.J. Washington,PF,24,CHO,73,73,2380,434,978,149,428,285,550,127,174,73,285,358,175,66,79,110,193,1144
500,TyTy Washington Jr.,PG,21,HOU,31,2,433,58,160,19,80,39,80,10,18,2,43,45,47,15,2,14,29,145
501,Yuta Watanabe,SF,28,BRK,58,1,928,114,232,60,135,54,97,34,47,30,111,141,48,25,17,22,80,322
502,Lindy Waters III,SG,25,OKC,41,0,531,70,178,58,162,12,16,16,20,16,59,75,28,14,11,10,42,214
503,Trendon Watford,PF,22,POR,62,12,1182,181,323,25,64,156,259,72,100,42,196,238,130,32,12,71,118,459
504,Peyton Watson,SG,20,DEN,23,2,186,29,59,6,14,23,45,11,20,8,29,37,11,2,11,8,14,75
505,Blake Wesley,SG,19,SAS,37,1,669,69,215,20,52,49,163,26,44,11,70,81,99,25,5,65,67,184
506,Russell Westbrook,PG,34,TOT,73,24,2126,432,991,89,286,343,705,206,314,89,334,423,551,76,33,255,162,1159
507,Coby White,SG,22,CHI,74,2,1730,263,594,128,344,135,250,61,70,16,196,212,204,54,6,74,122,715
508,Derrick White,SG,28,BOS,82,70,2319,350,758,149,391,201,367,168,192,52,241,293,321,54,76,95,177,1017
509,Jack White,SF,25,DEN,17,0,66,8,19,3,9,5,10,2,3,6,11,17,4,3,2,2,9,21
510,Joe Wieskamp,SF,23,TOR,9,0,50,3,14,3,12,0,2,0,0,0,4,4,3,0,0,1,3,9
511,Aaron Wiggins,SG,24,OKC,70,14,1297,186,363,48,122,138,241,59,71,68,142,210,80,39,15,55,110,479
512,Andrew Wiggins,SF,27,GSW,37,37,1190,250,529,89,225,161,304,44,72,61,125,186,85,45,28,48,107,633
513,Lindell Wigginton,PG,24,MIL,7,1,87,18,37,6,18,12,19,8,9,0,7,7,14,0,2,12,7,50
514,Alondes Williams,SG,23,BRK,1,0,5,0,0,0,0,0,0,0,0,0,1,1,0,0,0,2,1,0
515,Donovan Williams,SG,21,ATL,2,0,4,2,5,0,2,2,3,0,0,0,2,2,0,0,0,0,0,4
516,Grant Williams,PF,24,BOS,79,23,2045,216,476,115,291,101,185,94,122,87,276,363,131,41,31,82,192,641
517,Jalen Williams,SG,21,OKC,75,62,2276,414,794,73,205,341,589,155,191,84,253,337,248,103,35,123,191,1056
518,Jaylin Williams,C,20,OKC,49,36,914,102,234,46,113,56,121,38,54,44,197,241,76,28,12,37,111,288
519,Jeenathan Williams,SG,23,POR,5,4,127,24,39,3,8,21,31,2,3,10,5,15,10,3,2,4,13,53
520,Kenrich Williams,PF,28,OKC,53,10,1206,179,346,50,134,129,212,17,39,97,164,261,105,45,14,32,112,425
521,Mark Williams,C,21,CHO,43,17,828,160,251,0,0,160,251,67,97,93,211,304,18,28,45,40,94,387
522,Patrick Williams,PF,21,CHI,82,65,2323,314,677,115,277,199,400,90,105,78,249,327,100,72,70,101,147,833
523,Robert Williams,C,25,BOS,35,20,824,127,170,0,1,127,169,25,41,104,188,292,50,22,48,34,68,279
524,Vince Williams Jr.,SG,22,MEM,15,1,105,12,40,4,28,8,12,2,2,4,11,15,4,6,2,5,12,30
525,Ziaire Williams,SF,21,MEM,37,4,561,84,196,25,97,59,99,17,22,16,63,79,35,14,6,37,58,210
526,Zion Williamson,PF,22,NOP,29,29,956,285,469,7,19,278,450,177,248,58,144,202,133,32,16,99,65,754
527,Dylan Windler,SF,26,CLE,3,0,10,2,3,1,2,1,1,0,0,0,0,0,1,1,0,1,0,5
528,Justise Winslow,PF,26,POR,29,11,776,81,198,14,45,67,153,20,28,49,96,145,98,30,11,43,89,196
529,James Wiseman,C,21,TOT,45,22,867,189,339,4,20,185,319,68,97,73,194,267,30,7,27,51,108,450
530,Christian Wood,C,27,DAL,67,17,1738,396,769,105,279,291,490,217,281,87,404,491,121,30,72,121,169,1114
531,Delon Wright,PG,30,WAS,50,14,1221,138,291,41,119,97,172,52,60,58,122,180,194,92,17,44,59,369
532,McKinley Wright IV,PG,24,DAL,27,1,335,46,98,9,28,37,70,13,19,9,38,47,58,8,5,19,24,114
533,Gabe York,SG,29,IND,3,0,56,8,21,6,18,2,3,2,2,0,6,6,5,2,0,0,5,24
534,Thaddeus Young,PF,34,TOR,54,9,795,108,198,6,34,102,164,18,26,71,95,166,75,54,5,42,88,240
535,Trae Young,PG,24,ATL,73,73,2541,597,1390,154,460,443,930,566,639,56,161,217,741,80,9,300,104,1914
536,Omer Yurtseven,C,24,MIA,9,0,83,16,27,3,7,13,20,5,6,8,15,23,2,2,2,4,16,40
537,Cody Zeller,C,30,MIA,15,2,217,37,59,0,2,37,57,24,35,25,39,64,10,3,4,14,33,98
538,Ivica Zubac,C,25,LAC,76,76,2170,326,514,0,2,326,512,166,238,236,520,756,77,29,98,117,219,818
